阿姨	ā yí	a1 yi2	maternal aunt; step-mother; childcare worker; nursemaid; woman of similar age to one's parents (term of address used by child); CL:個|个[ge4]
啊	a	a5	"modal particle ending sentence, showing affirmation, approval, or consent"
矮	ǎi	ai3	low; short (in length)
爱	ài	ai4	to love; affection; to be fond of; to like
爱好	ài hào	ai4 hao4	to like; to take pleasure in; keen on; fond of; interest; hobby; appetite for; CL:個|个[ge4]
爱情	ài qíng	ai4 qing2	romance; love (romantic); CL:個|个[ge4]
安静	ān jìng	an1 jing4	quiet; peaceful; calm
安排	ān pái	an1 pai2	to arrange; to plan; to set up
安全	ān quán	an1 quan2	safe; secure; safety; security
暗	àn	an4	dark; gloomy; hidden; secret; muddled; obscure; in the dark
按时	àn shí	an4 shi2	on time; before deadline; on schedule
按照	àn zhào	an4 zhao4	according to; in accordance with; in the light of; on the basis of
八	bā	ba1	eight; 8
把	bǎ	ba3	to hold; to contain; to grasp; to take hold of; a handle; particle marking the following noun as a direct object; classifier for objects with handle
爸爸	bà ba	ba4 ba5	"(informal) father; CL:個|个[ge4],位[wei4]"
吧	ba	ba5	(modal particle indicating polite suggestion); ...right?; ...OK?
白	bái	bai2	white; snowy; pure; bright; empty; blank; plain; clear; to make clear; in vain; gratuitous; free of charge; reactionary; anti-communist; funeral; to stare coldly; to write wrong character; to state; to explain; vernacular; spoken lines in opera; surname Bai
百	bǎi	bai3	hundred; numerous; all kinds of; surname Bai
班	bān	ban1	team; class; squad; work shift; classifier for groups; ranking; surname Ban; CL:個|个[ge4]
搬	bān	ban1	to move; to shift; to remove; to transport; to apply indiscriminately; to copy mechanically
半	bàn	ban4	half; semi-; incomplete; (after a number) and a half
办法	bàn fǎ	ban4 fa3	"means; method; way (of doing sth); CL:條|条[tiao2],個|个[ge4]"
办公室	bàn gōng shì	ban4 gong1 shi4	an office; business premises; a bureau; CL:間|间[jian1]
帮忙	bāng máng	bang1 mang2	to help; to lend a hand; to do a favor; to do a good turn
帮助	bāng zhù	bang1 zhu4	assistance; aid; to help; to assist
包	bāo	bao1	"to cover; to wrap; to hold; to include; to take charge of; package; wrapper; container; bag; to hold or embrace; bundle; packet; to contract (to or for); surname Bao; CL:個|个[ge4],隻|只[zhi1]"
包括	bāo kuò	bao1 kuo4	to comprise; to include; to involve; to incorporate; to consist of
饱	bǎo	bao3	to eat till full; satisfied
保护	bǎo hù	bao3 hu4	to protect; to defend; to safeguard; protection; CL:種|种[zhong3]
保证	bǎo zhèng	bao3 zheng4	guarantee; to guarantee; to ensure; to safeguard; to pledge; CL:個|个[ge4]
抱	bào	bao4	to hold; to carry (in one's arms); to hug or embrace; surround; cherish
抱歉	bào qiàn	bao4 qian4	sorry; We apologize!; to feel apologetic; to regret
报道	bào dào	bao4 dao4	"report; CL:篇[pian1],份[fen4]"
报名	bào míng	bao4 ming2	to sign up; to enter one's name; to apply; to register; to enroll; to enlist
报纸	bào zhǐ	bao4 zhi3	"newspaper; newsprint; CL:份[fen4],期[qi1],張|张[zhang1]"
杯子	bēi zi	bei1 zi5	"cup; glass; CL:個|个[ge4],支[zhi1],枝[zhi1]"
北方	běi fāng	bei3 fang1	north; the northern part a country; China north of the Yellow River
北京	běi jīng	Bei3 jing1	"Beijing, capital of People's Republic of China; Peking; PRC government"
倍	bèi	bei4	"(two, three etc) -fold; times (multiplier); double; to increase or multiply"
被	bèi	bei4	by (indicates passive-voice sentences or clauses); quilt; to cover (literary)
本	běn	ben3	"roots or stems of plants; origin; source; this; the current; root; foundation; basis; classifier for books, periodicals, files etc; originally"
本来	běn lái	ben3 lai2	original; originally; at first; it goes without saying; of course
笨	bèn	ben4	stupid; foolish; silly; slow-witted; clumsy
鼻子	bí zi	bi2 zi5	"nose; CL:個|个[ge4],隻|只[zhi1]"
比	bǐ	bi3	"(particle used for comparison and ""-er than""); to compare; to contrast; to gesture (with hands); ratio"
比较	bǐ jiào	bi3 jiao4	compare; contrast; fairly; comparatively; relatively; quite; rather
比赛	bǐ sài	bi3 sai4	"competition (sports etc); match; CL:場|场[chang3],次[ci4]"
笔记本	bǐ jì běn	bi3 ji4 ben3	notebook; CL:本[ben3]
必须	bì xū	bi4 xu1	to have to; must; compulsory; necessarily
毕业	bì yè	bi4 ye4	graduation; to graduate; to finish school
遍	biàn	bian4	a time; everywhere; turn; all over; one time
变化	biàn huà	bian4 hua4	change; variation; to change; to vary; CL:個|个[ge4]
标准	biāo zhǔn	biao1 zhun3	(an official) standard; norm; criterion; CL:個|个[ge4]
表达	biǎo dá	biao3 da2	to voice (an opinion); to express; to convey
表格	biǎo gé	biao3 ge2	"form; table; CL:張|张[zhang1],份[fen4]"
表示	biǎo shì	biao3 shi4	to express; to show; to say; to state; to indicate; to mean
表演	biǎo yǎn	biao3 yan3	play; show; performance; exhibition; to perform; to act; to demonstrate; CL:場|场[chang3]
表扬	biǎo yáng	biao3 yang2	to praise; to commend
别	bié	bie2	to leave; to depart; to separate; to distinguish; to classify; other; another; do not; must not; to pin
别人	bié rén	bie2 ren2	other people; others; other person
宾馆	bīn guǎn	bin1 guan3	"guesthouse; CL:個|个[ge4],家[jia1]"
冰箱	bīng xiāng	bing1 xiang1	"icebox; freezer cabinet; refrigerator; CL:臺|台[tai2],個|个[ge4]"
饼干	bǐng gān	bing3 gan1	"biscuit; cracker; cookie; CL:片[pian4],塊|块[kuai4]"
并且	bìng qiě	bing4 qie3	and; besides; moreover; furthermore; in addition
博士	bó shì	bo2 shi4	doctor; court academician (in feudal China); Ph.D.
不但	bù dàn	bu4 dan4	not only (... but also...)
不过	bù guò	bu4 guo4	only; merely; no more than; but; however; anyway (to get back to a previous topic)
不客气	bù kè qi	bu4 ke4 qi5	you're welcome; impolite; rude; blunt; don't mention it
不	bù	bu4	(negative prefix); not; no
不得不	bù dé bù	bu4 de2 bu4	have no choice or option but to; cannot but; have to; can't help it; can't avoid
不管	bù guǎn	bu4 guan3	"no matter (what, how); regardless of; no matter"
不仅	bù jǐn	bu4 jin3	not only (this one); not just (...) but also
部分	bù fèn	bu4 fen4	part; share; section; piece; CL:個|个[ge4]
擦	cā	ca1	to wipe; to erase; rubbing (brush stroke in painting); to clean; to polish
猜	cāi	cai1	to guess
才	cái	cai2	ability; talent; endowment; gift; an expert; only (then); only if; just
材料	cái liào	cai2 liao4	"material; data; makings; stuff; CL:個|个[ge4],種|种[zhong3]"
菜	cài	cai4	"dish (type of food); vegetables; vegetable; cuisine; CL:盤|盘[pan2],道[dao4]"
菜单	cài dān	cai4 dan1	"menu; CL:份[fen4],張|张[zhang1]"
参观	cān guān	can1 guan1	to look around; to inspect; visit and observe
参加	cān jiā	can1 jia1	to participate; to take part; to join
草	cǎo	cao3	"grass; straw; manuscript; draft (of a document); careless; rough; CL:棵[ke1],撮[zuo3],株[zhu1],根[gen1]"
层	céng	ceng2	layer; stratum; laminated; floor (of a building); storey; classifier for layers; repeated; sheaf (math.)
茶	chá	cha2	"tea; tea plant; CL:杯[bei1],壺|壶[hu2]"
差	chà	cha4	differ from; short of; to lack; poor
差不多	chà bu duō	cha4 bu5 duo1	almost; nearly; more or less
尝	cháng	chang2	to taste; flavor; (past tense marker); already; formerly; ever; once; test
长	zhǎng	chang2	length; long; forever; always; constantly
长城	cháng chéng	Chang2 cheng2	the Great Wall
长江	cháng jiāng	Chang2 jiang1	Changjiang river; Yangtze river
场	chǎng	chang3	large place used for a specific purpose; stage; scene (of a play); classifier for sporting or recreational activities; classifier for number of exams
唱歌	chàng gē	chang4 ge1	to sing a song
超过	chāo guò	chao1 guo4	to surpass; to exceed; to outstrip
超市	chāo shì	chao1 shi4	supermarket (abbr.); CL:家[jia1]
吵	chǎo	chao3	to quarrel; to make a noise; noisy; to disturb by making a noise
衬衫	chèn shān	chen4 shan1	shirt; blouse; CL:件[jian4]
成功	chéng gōng	cheng2 gong1	"success; to succeed; CL:次[ci4],個|个[ge4]"
成绩	chéng jì	cheng2 ji4	"achievement; performance records; grades; CL:項|项[xiang4],個|个[ge4]"
成熟	chéng shú	cheng2 shu2	mature; ripe; Taiwan pr. cheng2 shou2
成为	chéng wéi	cheng2 wei2	to become; to turn into
诚实	chéng shí	cheng2 shi2	honest; honesty; honorable; truthful
城市	chéng shì	cheng2 shi4	city; town; CL:座[zuo4]
乘坐	chéng zuò	cheng2 zuo4	to ride (in a vehicle)
吃	chī	chi1	to eat; to have one's meal; to eradicate; to destroy; to absorb; to suffer; to exhaust
吃惊	chī jīng	chi1 jing1	to be startled; to be shocked; to be amazed
迟到	chí dào	chi2 dao4	to arrive late
重新	chóng xīn	chong2 xin1	again; once more; re-
抽烟	chōu yān	chou1 yan1	"to smoke (a cigarette, tobacco)"
出	chū	chu1	"to go out; to come out; to occur; to produce; to go beyond; to rise; to put forth; to happen; classifier for dramas, plays, operas etc"
出差	chū chāi	chu1 chai1	to go on an official or business trip
出发	chū fā	chu1 fa1	to start out; to set off
出生	chū shēng	chu1 sheng1	to be born
出现	chū xiàn	chu1 xian4	to appear; to arise; to emerge; to show up
出租车	chū zū chē	chu1 zu1 che1	taxi
厨房	chú fáng	chu2 fang2	kitchen; CL:間|间[jian1]
除了	chú le	chu2 le5	besides; apart from (... also...); in addition to; except (for)
穿	chuān	chuan1	to bore through; pierce; perforate; penetrate; pass through; to dress; to wear; to put on; to thread
船	chuán	chuan2	"a boat; vessel; ship; CL:條|条[tiao2],艘[sou1],隻|只[zhi1]"
传真	chuán zhēn	chuan2 zhen1	fax; facsimile
窗户	chuāng hu	chuang1 hu5	"window; CL:個|个[ge4],扇[shan4]"
春	chūn	chun1	spring (time); gay; joyful; youthful; love; lust; life
词典	cí diǎn	ci2 dian3	"dictionary (of Chinese compound words); also written 辭典|辞典[ci2 dian3]; CL:部[bu4],本[ben3]"
词语	cí yǔ	ci2 yu3	word (general term including monosyllables through to short phrases); term (e.g. technical term); expression
次	cì	ci4	"next in sequence; second; the second (day, time etc); secondary; vice-; sub-; infra-; inferior quality; substandard; order; sequence; hypo- (chemistry); classifier for enumerated events: time"
聪明	cōng ming5	cong1 ming5	acute (of sight and hearing); clever; intelligent; bright; smart
从	cóng	cong2	"from; via; passing through; through (a gap); past; ever (followed by negative, meaning never); (formerly pr. zong4 and related to 縱|纵) to follow; to comply with; to obey; to join; to engage in; adopting some mode of action or attitude; follower; retainer; accessory; accomplice; related by common paternal grandfather or earlier ancestor; surname Cong"
从来	cóng lái	cong2 lai2	always; at all times; never (if used in negative sentence)
粗心	cū xīn	cu1 xin1	careless; thoughtless
错	cuò	cuo4	mistake; error; blunder; fault; cross; uneven; wrong; CL:個|个[ge4]
答案	dá àn	da2 an4	answer; solution; CL:個|个[ge4]
打扮	dǎ ban5	da3 ban5	to decorate; to dress; to make up; to adorn; manner of dressing; style of dress
打电话	dǎ diàn huà	da3 dian4 hua4	to make a telephone call
打篮球	dǎ lán qiú	da3 lan2 qiu2	play basketball
打扰	dǎ rǎo	da3 rao3	to disturb; to bother; to trouble
打扫	dǎ sǎo	da3 sao3	to clean; to sweep
打算	dǎ suàn	da3 suan4	to plan; to intend; to calculate; plan; intention; calculation; CL:個|个[ge4]
打印	dǎ yìn	da3 yin4	to print; to seal; to stamp
打折	dǎ zhé	da3 zhe2	to give a discount
打针	dǎ zhēn	da3 zhen1	to give or have an injection
大	dà	da4	big; huge; large; major; great; wide; deep; oldest; eldest
大概	dà gài	da4 gai4	roughly; probably; rough; approximate; about
大家	dà jiā	da4 jia1	authority; everyone
大使馆	dà shǐ guǎn	da4 shi3 guan3	"embassy; CL:座[zuo4],個|个[ge4]"
大约	dà yuē	da4 yue1	approximately; about
带	dài	dai4	band; belt; girdle; ribbon; tire; area; zone; region; CL:條|条[tiao2]; to wear; to carry; to lead; to bring; to look after; to raise
戴	dài	dai4	"to put on or wear (glasses, hat, gloves etc); to respect; to bear; to support"
代表	dài biǎo	dai4 biao3	"representative; delegate; CL:位[wei4],個|个[ge4],名[ming2]; to represent; to stand for; on behalf of; in the name of"
代替	dài tì	dai4 ti4	"instead; to replace; to substitute (X for Y, or a number in an algebraic expression)"
大夫	dài fu	dai4 fu5	"doctor; minister of state (in pre-Han states); CL:個|个[ge4],位[wei4]"
担心	dān xīn	dan1 xin1	anxious; worried; uneasy; to worry; to be anxious
蛋糕	dàn gāo	dan4 gao1	"cake; CL:塊|块[kuai4],個|个[ge4]"
但是	dàn shì	dan4 shi4	but; however
当	dāng	dang1	to be; to act as; manage; withstand; when; during; ought; should; match equally; equal; same; obstruct; just at (a time or place); on the spot; right; just at
当地	dāng dì	dang1 di4	local
当然	dāng rán	dang1 ran2	only natural; as it should be; certainly; of course; without doubt
当时	dāng shí	dang1 shi2	then; at that time; while
刀	dāo	dao1	knife; CL:把[ba3]
导游	dǎo yóu	dao3 you2	tour guide; to conduct a tour; a guidebook
到	dào	dao4	to (a place); until (a time); up to; to go; to arrive
到处	dào chù	dao4 chu4	in all places; everywhere
到底	dào dǐ	dao4 di3	finally; in the end; when all is said and done; after all; to the end; to the last
道歉	dào qiàn	dao4 qian4	to apologize; to make an apology
得意	dé yì	de2 yi4	proud of oneself; pleased with oneself; complacent
地	de	de5	"-ly; structural particle: used before a verb or adjective, linking it to preceding modifying adverbial adjunct"
的	de	de5	"of; structural particle: used before a noun, linking it to preceding possessive or descriptive attributive"
得	děi	de5	"structural particle: used after a verb (or adjective as main verb), linking it to following phrase indicating effect, degree, possibility etc"
灯	dēng	deng1	lamp; light; lantern; CL:盞|盏[zhan3]
等	děng	deng3	wait for; await
低	dī	di1	low; beneath; to lower (one's head); to let droop; to hang down; to incline
底	dǐ	di3	background; bottom; base; the end of a period of time; towards the end of (last month)
弟弟	dì di	di4 di5	"younger brother; CL:個|个[ge4],位[wei4]"
地方	dì fāng	di4 fang1	region; regional (away from the central administration)
地球	dì qiú	di4 qiu2	the Earth; planet; CL:個|个[ge4]
地铁	dì tiě	di4 tie3	subway; metro
地图	dì tú	di4 tu2	"map; CL:張|张[zhang1],本[ben3]"
地址	dì zhǐ	di4 zhi3	address; CL:個|个[ge4]
第一	dì yī	di4 yi1	first; number one
点	diǎn	dian3	drop (of liquid); stain; spot; speck; jot; dot stroke (in Chinese characters); decimal point; point; mark (of degree or level); a place (with certain characteristics); iron bell; o’clock; a little; a bit; some; (point) unit of measurement for type; to touch on briefly; to make clear; to light; to ignite; to kindle; period of time at night (24 minutes) (old); a drip; to dibble; classifier for small indeterminate quantities
电脑	diàn nǎo	dian4 nao3	computer; CL:臺|台[tai2]
电视	diàn shì	dian4 shi4	"television; TV; CL:臺|台[tai2],個|个[ge4]"
电梯	diàn tī	dian4 ti1	"elevator; CL:臺|台[tai2],部[bu4]"
电影	diàn yǐng	dian4 ying3	"movie; film; CL:部[bu4],片[pian4],幕[mu4],場|场[chang3]"
电子邮件	diàn zǐ yóu jiàn	dian4 zi3 you2 jian4	electronic mail; email; CL:封[feng1]
掉	diào	diao4	"to fall; to drop; to lag behind; to lose; to go missing; to reduce; fall (in prices); to lose (value, weight etc); to wag; to swing; to turn; to change; to exchange; to swap; to show off; to shed (hair)"
调查	diào chá	diao4 cha2	"investigation; inquiry; to investigate; to survey; survey; (opinion) poll; CL:項|项[xiang4],個|个[ge4]"
丢	diū	diu1	to lose; to put aside; to throw
冬	dōng	dong1	winter
东	dōng	dong1	east; host (i.e. sitting on east side of guest); landlord; surname Dong
东西	dōng xi	dong1 xi5	"thing; stuff; person; CL:個|个[ge4],件[jian4]"
懂	dǒng	dong3	to understand; to know
动物	dòng wù	dong4 wu4	"animal; CL:隻|只[zhi1],群[qun2],個|个[ge4]"
动作	dòng zuò	dong4 zuo4	movement; motion; action; CL:個|个[ge4]
都	dōu	dou1	"all, both; entirely (due to) each; even; already"
读	dú	du2	"to read; to study; reading of word (i.e. pronunciation), similar to 拼音[pin1 yin1]"
堵车	dǔ chē	du3 che1	traffic jam; choking
肚子	dù zi	du4 zi5	belly; abdomen; stomach; CL:個|个[ge4]
短	duǎn	duan3	short or brief; to lack; weak point; fault
段	duàn	duan4	"paragraph; section; segment; stage (of a process); classifier for stories, periods of time, lengths of thread etc"
断	duàn	duan4	"to break; to snap; to cut off; to give up or abstain from sth; to judge; (usu. used in the negative) absolutely, definitely,decidedly"
锻炼	duàn liàn	duan4 lian4	to engage in physical exercise; to toughen; to temper
对	duì	dui4	couple; pair; to be opposite; to oppose; to face; versus; for; to; correct (answer); to answer; to reply; to direct (towards sth); right
对不起	duì bu qǐ	dui4 bu5 qi3	unworthy; to let down; I'm sorry; excuse me; pardon me; if you please; sorry? (please repeat)
对话	duì huà	dui4 hua4	dialog; CL:個|个[ge4]
对面	duì miàn	dui4 mian4	opposite
顿	dùn	dun4	"stop; pause; to arrange; to lay out; to kowtow; to stamp; at once; classifier for meals, beating, tellings off etc: time, bout, spell, meal"
多	duō	duo1	many; much; a lot of; numerous; multi-
多么	duō me	duo1 me5	how (wonderful etc); what (a great idea etc); however (difficult it may be etc)
多少	duō shǎo	duo1 shao3	number; amount; somewhat
朵	duǒ	duo3	"flower; earlobe; fig. item on both sides; classifier for flowers, clouds etc"
饿	è	e4	to be hungry; hungry
而	ér	er2	and; as well as; and so; but (not); yet (not); (indicates causal relation); (indicates change of state); (indicates contrast)
而且	ér qiě	er2 qie3	(not only ...) but also; moreover; in addition; furthermore
儿童	ér tóng	er2 tong2	child; CL:個|个[ge4]
儿子	ér zi	er2 zi5	son
耳朵	ěr duo	er3 duo5	"ear; CL:隻|只[zhi1],個|个[ge4],對|对[dui4]"
二	èr	er4	two; 2; stupid (Beijing dialect)
发	fā	fa1	to send out; to show (one's feeling); to issue; to develop; classifier for gunshots (rounds)
发烧	fā shāo	fa1 shao1	have a high temperature (from illness); have a fever
发生	fā shēng	fa1 sheng1	to happen; to occur; to take place; to break out
发现	fā xiàn	fa1 xian4	to find; to discover
发展	fā zhǎn	fa1 zhan3	development; growth; to develop; to grow; to expand
法律	fǎ lv4	fa3 lv4	"law; CL:條|条[tiao2], 套[tao4], 個|个[ge4]"
翻译	fān yì	fan1 yi4	"to translate; to interpret; translator; interpreter; translation; interpretation; CL:個|个[ge4],位[wei4],名[ming2]"
烦恼	fán nǎo	fan2 nao3	agonize; agony; annoyance; upset; vexation; worries
反对	fǎn duì	fan3 dui4	to fight against; to oppose; to be opposed to; opposition
反应	fǎn yìng	fan3 ying4	"to mirror; to reflect; mirror image; reflection; fig. to report; to make known; to render; used erroneously for 反應|反应, response or reaction"
饭馆	fàn guǎn	fan4 guan3	restaurant; CL:家[jia1]
范围	fàn wéi	fan4 wei2	range; scope; limit; extent; CL:個|个[ge4]
方便	fāng biàn	fang1 bian4	convenient; to help out; to make things easy for people; convenience; suitable; having money to spare; (euphemism) to go to the toilet
方法	fāng fǎ	fang1 fa3	method; way; means; CL:個|个[ge4]
方面	fāng miàn	fang1 mian4	respect; aspect; field; side; CL:個|个[ge4]
方向	fāng xiàng	fang1 xiang4	direction; orientation; path to follow; CL:個|个[ge4]
房间	fáng jiān	fang2 jian1	room; CL:間|间[jian1]
访问	fǎng wèn	fang3 wen4	to visit; to call on; to interview; CL:次[ci4]
放	fàng	fang4	to release; to free; to let go; to put; to place; to let out; to set off (fireworks)
放弃	fàng qì	fang4 qi4	to renounce; to abandon; to give up
放暑假	fàng shǔ jià	fang4 shu3 jia4	take summer vacation
放心	fàng xīn	fang4 xin1	to set one's mind at rest; to be at ease; to rest
非常	fēi cháng	fei1 chang2	unusual; extraordinary; extreme; very; exceptional
飞机	fēi jī	fei1 ji1	airplane; CL: 架[jia4]
分	fēn	fen1	to divide; to separate; to allocate; to distinguish (good and bad); part or subdivision; fraction; one tenth (of certain units); unit of length equivalent to 0.33 cm; minute; a point (in sports or games); 0.01 yuan (unit of money)
…分之…	fēn zhī	fen1 zhi1	"used for fractions and percentages, e.g. 四分之一 is 1/4 and 百分之一 is 1%"
分钟	fēn zhōng	fen1 zhong1	minute
份	fèn	fen4	"part; share; portion; copy; classifier for gifts, newspaper, magazine, papers, reports, contracts etc"
丰富	fēng fù	feng1 fu4	rich; plentiful; abundant
风景	fēng jǐng	feng1 jing3	scenery; landscape; CL:個|个[ge4]
否则	fǒu zé	fou3 ze2	if not; otherwise; else; or else
符合	fú hé	fu2 he2	in keeping with; in accordance with; tallying with; in line with; to agree with; to accord with; to conform to; to correspond with; to manage; to handle
服务员	fú wù yuán	fu2 wu4 yuan2	waiter; waitress; attendant; customer service personnel; CL:個|个[ge4]
富	fù	fu4	rich; surname Fu
附近	fù jìn	fu4 jin4	(in the) vicinity; nearby; neighboring; next to
父亲	fù qīn	fu4 qin1	father; also pr. with light tone [fu4 qin5]; CL:個|个[ge4]
复习	fù xí	fu4 xi2	to revise; to review; revision; CL:次[ci4]
复印	fù yìn	fu4 yin4	to photocopy; to duplicate a document
复杂	fù zá	fu4 za2	complicated; complex
负责	fù zé	fu4 ze2	to be in charge of; to take responsibility for; to be to blame; conscientious
改变	gǎi biàn	gai3 bian4	to change; to alter; to transform
干杯	gān bēi	gan1 bei1	to drink a toast; Cheers! (proposing a toast); Here's to you!; Bottoms up!; lit. dry cup
干净	gān jìng	gan1 jing4	clean; neat
干燥	gān zào	gan1 zao4	"to dry (of weather, paint, cement etc); desiccation; dull; uninteresting; arid"
敢	gǎn	gan3	to dare; daring; (polite) may I venture
感动	gǎn dòng	gan3 dong4	to move (sb); to touch (sb emotionally); moving
感觉	gǎn jué	gan3 jue2	to feel; to become aware of; feeling; sense; perception; CL:個|个[ge4]
感冒	gǎn mào	gan3 mao4	"to catch cold; (common) cold; CL:場|场[chang2],次[ci4]"
感情	gǎn qíng	gan3 qing2	"feeling; emotion; sensation; likes and dislikes; deep affection for sb or sth; relationship (i.e. love affair); CL:個|个[ge4],種|种[zhong3]"
感谢	gǎn xiè	gan3 xie4	(express) thanks; gratitude; grateful; thankful; thanks
干	gān	gan1	to work; to do; to manage
刚才	gāng cái	gang1 cai2	just now; a moment ago
刚刚	gāng gang5	gang1 gang5	just recently; just a moment ago
高	gāo	gao1	high; tall; above average; loud; your (honorific); surname Gao
高级	gāo jí	gao1 ji2	high level; high grade; advanced; high-ranking
高兴	gāo xìng	gao1 xing4	happy; glad; willing (to do sth); in a cheerful mood
告诉	gào su	gao4 su5	to tell; to inform; to let know
哥哥	gē ge	ge1 ge5	"older brother; CL:個|个[ge4],位[wei4]"
各	gè	ge4	each; every
个	gè	ge4	individual; this; that; size; classifier for people or objects in general
个子	gè zi	ge4 zi5	height; stature; build; size
给	gěi	gei3	to; for; for the benefit of; to give; to allow; to do sth (for sb); (passive particle)
跟	gēn	gen1	heel; to follow closely; to go with; to marry sb (of woman); with; towards; as (compared to); from (different from); and (in addition to)
根据	gēn jù	gen1 ju4	according to; based on; basis; foundation; CL:個|个[ge4]
更	gēng	geng1	to change or replace; to experience; one of the five two hour periods into which the night was formerly divided; watch (eg of a sentry or guard)
公共汽车	gōng gòng qì chē	gong1 gong4 qi4 che1	"bus; CL:輛|辆[liang4],班[ban1]"
公斤	gōng jīn	gong1 jin1	kilogram (kg)
公里	gōng lǐ	gong1 li3	kilometer
公司	gōng sī	gong1 si1	(business) company; company; firm; corporation; incorporated; CL:家[jia1]
公园	gōng yuán	gong1 yuan2	public park; CL:場|场[chang3]
工具	gōng jù	gong1 ju4	tool; instrument; utensil; means (to achieve a goal etc)
工资	gōng zī	gong1 zi1	"wages; pay; CL:個|个[ge4],份[fen4],月[yue4]"
工作	gōng zuò	gong1 zuo4	"job; work; construction; task; CL:個|个[ge4],份[fen4],項|项[xiang4]"
共同	gòng tóng	gong4 tong2	common; joint; jointly; together; collaborative
狗	gǒu	gou3	"dog; CL:隻|只[zhi1],條|条[tiao2]"
够	gòu	gou4	to reach; to be enough
购物	gòu wù	gou4 wu4	shopping
孤单	gū dān	gu1 dan1	lone; lonely; loneliness
估计	gū jì	gu1 ji4	to estimate; to reckon; CL:個|个[ge4]
鼓励	gǔ lì	gu3 li4	to encourage
鼓掌	gǔ zhǎng	gu3 zhang3	to applaud; to clap
顾客	gù kè	gu4 ke4	client; customer; CL:位[wei4]
故事	gù shì	gu4 shi4	old practice; CL:個|个[ge4]
故意	gù yì	gu4 yi4	deliberately; on purpose
刮风	guā fēng	gua1 feng1	to be windy
挂	guà	gua4	to hang or suspend (from a hook etc); (of a telephone call) to hang up; to be worried or concerned; to make a phone call (topolect); to register or record; to hitch; classifier for sets or clusters of objects
关	guān	guan1	mountain pass; to close; to shut; to turn off; to concern; to involve
关键	guān jiàn	guan1 jian4	crucial point; crux; CL:個|个[ge4]; key; crucial; pivotal
关系	guān xì	guan1 xi4	relation; relationship; to concern; to affect; to have to do with; guanxi; CL:個|个[ge4]
关心	guān xīn	guan1 xin1	to care for sth; caring; concerned
关于	guān yú	guan1 yu2	pertaining to; concerning; regarding; with regards to; about; a matter of
观众	guān zhòng	guan1 zhong4	spectators; audience; visitors (to an exhibition etc)
管理	guǎn lǐ	guan3 li3	to supervise; to manage; to administer; management; administration; CL:個|个[ge4]
光	guāng	guang1	light; ray; CL:道[dao4]; bright; only; merely; to use up
广播	guǎng bō	guang3 bo1	broadcast; widely spread; CL:個|个[ge4]
广告	guǎng gào	guang3 gao4	to advertise; a commercial; advertisement; CL:項|项[xiang4]
逛	guàng	guang4	to stroll; to visit
规定	guī dìng	gui1 ding4	provision; to fix; to set; to formulate; to stipulate; to provide; regulation; rule; CL:個|个[ge4]
贵	guì	gui4	expensive; noble; your (name); precious
国际	guó jì	guo2 ji4	international
国家	guó jiā	guo2 jia1	country; nation; state; CL:個|个[ge4]
果然	guǒ rán	guo3 ran2	really; sure enough; as expected
果汁	guǒ zhī	guo3 zhi1	fruit juice
过	guò	guo4	to cross; to go over; to pass (time); to celebrate (a holiday); to live; to get along; excessively; too-; surname Guo
过程	guò chéng	guo4 cheng2	course of events; process; CL:個|个[ge4]
过去	guò qu	guo4 qu5	(in the) past; former; previous; to go over; to pass by
还	huán	hai2	still; still in progress; still more; yet; even more; in addition; fairly; passably (good); as early as; even; also; else
还是	hái shì	hai2 shi4	or; still; nevertheless
孩子	hái zi	hai2 zi5	child
海洋	hǎi yáng	hai3 yang2	ocean; CL:個|个[ge4]
害怕	hài pà	hai4 pa4	to be afraid; to be scared
害羞	hài xiū	hai4 xiu1	blush; shy
寒假	hán jià	han2 jia4	winter vacation
汗	hàn	han4	"perspiration; sweat; CL:滴[di1],頭|头[tou2],身[shen1]; Khan (Persian or Mongol king or emperor); Khan (name); to be speechless (out of helplessness, embarrassment etc) (Internet slang used as an interjection)"
汉语	hàn yǔ	Han4 yu3	Chinese language; CL:門|门[men2]
航班	háng bān	hang2 ban1	scheduled flight; flight number; plane; scheduled sailing; sailing number; passenger ship
好	hǎo	hao3	good; well; proper; good to; easy to; very; so; (suffix indicating completion or readiness)
好吃	hǎo chī	hao3 chi1	tasty; delicious
好处	hǎo chu	hao3 chu5	benefit; advantage; gain; profit; also pronounced hao3 chu4; CL:個|个[ge4]
好像	hǎo xiàng	hao3 xiang4	as if; to seem like
号	hào	hao4	day of a month; (suffix used after) name of a ship; (ordinal) number
号码	hào mǎ	hao4 ma3	"number; CL:堆[dui1],個|个[ge4]"
喝	hē	he1	to drink; to shout (a command); My goodness!
和	hé	he2	and; together with; with; sum; union; peace; harmony; surname He; Japanese related; Taiwan pr.  han4
河	hé	he2	"river; CL:條|条[tiao2],道[dao4]"
合格	hé gé	he2 ge2	qualified; meeting a standard; eligible (voter)
合适	hé shì	he2 shi4	suitable; fitting; decent; to fit
盒子	hé zi	he2 zi5	case
黑	hēi	hei1	black; dark; abbr. for Heilongjiang 黑龍江|黑龙江 province in northeast China
黑板	hēi bǎn	hei1 ban3	"blackboard; CL:塊|块[kuai4],個|个[ge4]"
很	hěn	hen3	(adverb of degree); quite; very; awfully
红	hóng	hong2	bonus; popular; red; revolutionary
猴子	hóu zi	hou2 zi5	monkey; CL:隻|只[zhi1]
厚	hòu	hou4	thick; deep or profound; kind; generous; rich or strong in flavor; to favor; to stress
后悔	hòu huǐ	hou4 hui3	to regret; to repent
后来	hòu lái	hou4 lai2	afterwards; later
后面	hòu mian5	hou4 mian5	rear; back; behind; later; afterwards
忽然	hū rán	hu1 ran2	suddenly; all of a sudden
护士	hù shi	hu4 shi5	nurse; CL:個|个[ge4]
护照	hù zhào	hu4 zhao4	"passport; CL:本[ben3],個|个[ge4]"
互相	hù xiāng	hu4 xiang1	each other; mutually; mutual
花	huā	hua1	"flower; blossom; fancy pattern; CL:朵[duo3],支[zhi1],束[shu4],把[ba3],盆[pen2],簇[cu4]; to spend (money, time); surname Hua"
花园	huā yuán	hua1 yuan2	"garden; CL:座[zuo4],個|个[ge4]"
画	huà	hua4	"to draw; picture; painting; CL:幅[fu2],張|张[zhang1]"
怀疑	huái yí	huai2 yi2	to doubt; to suspect; doubt; suspicion; skeptical
坏	huài	huai4	bad; spoiled; broken; to break down
欢迎	huān yíng	huan1 ying2	to welcome; welcome
环境	huán jìng	huan2 jing4	environment; circumstances; surroundings; CL:個|个[ge4]; ambient
换	huàn	huan4	change; exchange
黄	huáng	huang2	yellow; pornographic; to fall through
回	huí	hui2	to circle; to go back; to turn around; to answer; to return; to revolve; Hui ethnic group (Chinese Muslims); time; classifier for acts of a play; section or chapter (of a classic book)
回答	huí dá	hui2 da2	to reply; to answer; the answer; CL:個|个[ge4]
回忆	huí yì	hui2 yi4	to recall; recollection; CL:個|个[ge4]
会	huì	hui4	can; be possible; be able to; will; be likely to; be sure to; to assemble; to meet; to gather; to see; union; group; association; CL:個|个[ge4]; a moment (Taiwan pr. for this sense is hui3)
会议	huì yì	hui4 yi4	"meeting; conference; CL:場|场[chang3],屆|届[jie4]"
活动	huó dòng	huo2 dong4	"to exercise; to move about; to operate; activity; loose; shaky; active; movable; maneuver; to use connections; CL:項|项[xiang4],個|个[ge4]"
活泼	huó po	huo2 po5	lively; vivacious; brisk; active
火	huǒ	huo3	fire; CL:把[ba3]
火车站	huǒ chē zhàn	huo3 che1 zhan4	train station
获得	huò dé	huo4 de2	to obtain; to receive; to get
或者	huò zhě	huo4 zhe3	or; possibly; maybe; perhaps
机场	jī chǎng	ji1 chang3	"airport; airfield; CL:家[jia1],處|处[chu4]"
机会	jī huì	ji1 hui4	opportunity; chance; occasion; CL:個|个[ge4]
基础	jī chǔ	ji1 chu3	base; foundation; basis; underlying; CL:個|个[ge4]
鸡蛋	jī dàn	ji1 dan4	"(chicken) egg; hen's egg; CL:個|个[ge4],打[da2]"
激动	jī dòng	ji1 dong4	to excite; to agitate; exciting
几乎	jī hū	ji1 hu1	almost; nearly; practically
积极	jī jí	ji1 ji2	active; energetic; vigorous; positive (outlook); proactive
积累	jī lěi	ji1 lei3	to accumulate; accumulation; cumulative; cumulatively
极	jí	ji2	"extremely; pole (geography, physics); utmost; top"
极其	jí qí	ji2 qi2	extremely
集合	jí hé	ji2 he2	a congregation; to gather; a set
及时	jí shí	ji2 shi2	in time; promptly; without delay; timely
即使	jí shǐ	ji2 shi3	even if; even though; given that
几	jǐ	ji3	how much; how many; several; a few
寄	jì	ji4	to live (in a house); to lodge; to mail; to send; to entrust; to depend
记得	jì de	ji4 de5	to remember
记者	jì zhě	ji4 zhe3	reporter; journalist; CL:個|个[ge4]
计划	jì huà	ji4 hua4	"plan; project; program; to plan; to map out; CL:個|个[ge4],項|项[xiang4]"
季节	jì jié	ji4 jie2	time; season; period; CL:個|个[ge4]
既然	jì rán	ji4 ran2	since; as; this being the case
技术	jì shù	ji4 shu4	"technology; technique; skill; CL:門|门[men2],種|种[zhong3],項|项[xiang4]"
继续	jì xù	ji4 xu4	to continue; to proceed with; to go on with
家	jiā	jia1	"home; family; classifier for families or businesses; refers to the philosophical schools of pre-Han China; noun suffix for specialists in some activity such as musician or revolutionary, corresponds to English -ist, -er, -ary or -ian; surname Jia; CL:個|个[ge4]"
家具	jiā jù	jia1 ju4	"furniture; CL:件[jian4],套[tao4]"
加班	jiā bān	jia1 ban1	to work overtime
加油站	jiā yóu zhàn	jia1 you2 zhan4	gas station
假	jiǎ	jia3	fake; false; artificial; to borrow; if; suppose
价格	jià gé	jia4 ge2	price; CL:個|个[ge4]
坚持	jiān chí	jian1 chi2	to continue upholding; to remain committed to; persistence; to persist; to uphold; to insist on; persevere
检查	jiǎn chá	jian3 cha2	inspection; to examine; to inspect; CL:次[ci4]
简单	jiǎn dān	jian3 dan1	simple; not complicated
减肥	jiǎn féi	jian3 fei2	to lose weight
减少	jiǎn shǎo	jian3 shao3	to lessen; to decrease; to reduce; to lower
件	jiàn	jian4	"item; component; classifier for events, things, clothes etc"
健康	jiàn kāng	jian4 kang1	health; healthy
见面	jiàn miàn	jian4 mian4	to meet; to see sb; CL:次[ci4]
将来	jiāng lái	jiang1 lai2	in the future; future; the future; CL:個|个[ge4]
讲	jiǎng	jiang3	to speak; to explain; to negotiate; to emphasise; to be particular about; as far as sth is concerned; speech; lecture
奖金	jiǎng jīn	jiang3 jin1	premium; award money; a bonus
降低	jiàng dī	jiang4 di1	to reduce; to lower; to bring down
教	jiāo	jiao1	to teach
交	jiāo	jiao1	to hand over; to deliver; to pay (money); to turn over; to make friends; to intersect (lines)
交流	jiāo liú	jiao1 liu2	exchange; give-and-take; to exchange; to alternate; communication; alternating current (electricity)
交通	jiāo tōng	jiao1 tong1	to be connected; traffic; communications; liaison
骄傲	jiāo ào	jiao1 ao4	arrogant; full of oneself; conceited; proud of sth; CL:個|个[ge4]
角	jiǎo	jiao3	angle; corner; horn; horn-shaped; unit of money equal to 0.1 yuan; CL:個|个[ge4]
脚	jiǎo	jiao3	"foot; leg; base; kick; CL:雙|双[shuang1],隻|只[zhi1]"
饺子	jiǎo zi	jiao3 zi5	"dumpling; pot-sticker; CL:個|个[ge4],隻|只[zhi1]"
叫	jiào	jiao4	to shout; to call; to order; to ask; to be called; by (indicates agent in the passive mood)
教室	jiào shì	jiao4 shi4	classroom; CL:間|间[jian1]
教授	jiào shòu	jiao4 shou4	"professor; to instruct; to lecture on; CL:個|个[ge4],位[wei4]"
教育	jiào yù	jiao4 yu4	to educate; to teach; education
接	jiē	jie1	to receive; to answer (the phone); to meet or welcome sb; to connect; to catch; to join; to extend; to take one's turn on duty; take over for sb
接受	jiē shòu	jie1 shou4	to accept; to receive
街道	jiē dào	jie1 dao4	street; CL:條|条[tiao2]
结果	jiē guǒ	jie1 guo3	to bear fruit; CL:個|个[ge4]
结婚	jié hūn	jie2 hun1	to marry; to get married; CL:次[ci4]
结束	jié shù	jie2 shu4	termination; to finish; to end; to conclude; to close
节目	jié mù	jie2 mu4	"program; item (on a program); CL:臺|台[tai2],個|个[ge4],套[tao4]"
节日	jié rì	jie2 ri4	holiday; festival; CL:個|个[ge4]
节约	jié yuē	jie2 yue1	to economize; to conserve (resources); economy; frugal
姐姐	jiě jie	jie3 jie5	older sister; CL:個|个[ge4]
解决	jiě jué	jie3 jue2	to settle (a dispute); to resolve; to solve
解释	jiě shì	jie3 shi4	explanation; to explain; to interpret; to resolve; CL:個|个[ge4]
借	jiè	jie4	to lend; to borrow; excuse; pretext; by means of; to seize (an opportunity); to take (an opportunity)
介绍	jiè shào	jie4 shao4	to present; to introduce; to recommend; to suggest; to let know; to brief
今天	jīn tiān	jin1 tian1	today; at the present; now
尽管	jǐn guǎn	jin3 guan3	"despite; although; even though; in spite of; unhesitatingly; do not hesitate (to ask, complain etc); (go ahead and do it) without hesitating"
紧张	jǐn zhāng	jin3 zhang1	nervous; keyed up; intense; tense; strained; in short supply; scarce; CL:陣|阵[zhen4]
近	jìn	jin4	near; close to; approximately
进	jìn	jin4	"to advance; to enter; to come (or go) into; to receive or admit; to eat or drink; to submit or present; (used after a verb) into, in; to score a goal"
进行	jìn xíng	jin4 xing2	to advance; to conduct; underway; in progress; to do; to carry out; to carry on; to execute
禁止	jìn zhǐ	jin4 zhi3	to prohibit; to forbid; to ban
精彩	jīng cǎi	jing1 cai3	brilliant; splendid
精神	jīng shén	jing1 shen2	spirit; mind; consciousness; thought; mental; psychological; essence; gist; CL:個|个[ge4]
经常	jīng cháng	jing1 chang2	day to day; everyday; daily; frequently; constantly; regularly; often
经过	jīng guò	jing1 guo4	to pass; to go through; process; course; CL:個|个[ge4]
经济	jīng jì	jing1 ji4	economy; economic
经理	jīng lǐ	jing1 li3	"manager; director; CL:個|个[ge4],位[wei4],名[ming2]"
经历	jīng lì	jing1 li4	"experience; CL:個|个[ge4],次[ci4]; to experience; to go through"
经验	jīng yàn	jing1 yan4	to experience; experience
京剧	jīng jù	Jing1 ju4	"Beijing opera; CL:場|场[chang3],出[chu1]"
警察	jǐng chá	jing3 cha2	police; policeman; policewoman; CL:個|个[ge4]
竟然	jìng rán	jing4 ran2	unexpectedly; to one's surprise; in spite of everything; in that crazy way; actually; to go as far as to
竞争	jìng zhēng	jing4 zheng1	to compete; competition
镜子	jìng zi	jing4 zi5	"mirror; CL:面[mian4],個|个[ge4]"
究竟	jiū jìng	jiu1 jing4	after all (when all is said and done); actually; outcome; result
九	jiǔ	jiu3	nine; 9
久	jiǔ	jiu3	(long) time; (long) duration of time
旧	jiù	jiu4	old; opposite: new 新; former; worn (with age)
就	jiù	jiu4	at once; right away; only; just (emphasis); as early as; already; as soon as; then; in that case; as many as; even if; to approach; to move towards; to undertake; to engage in; to suffer; subjected to; to accomplish; to take advantage of; to go with (of foods); with regard to; concerning
举办	jǔ bàn	ju3 ban4	to conduct; to hold
举行	jǔ xíng	ju3 xing2	"to hold (a meeting, ceremony etc)"
拒绝	jù jué	ju4 jue2	to refuse; to decline; to reject
距离	jù lí	ju4 li2	distance; to be apart; CL:個|个[ge4]
句子	jù zi	ju4 zi5	sentence; CL:個|个[ge4]
觉得	jué de	jue2 de5	to think; to feel
决定	jué dìng	jue2 ding4	"to decide (to do something); to resolve; decision; CL:個|个[ge4],項|项[xiang4]; certainly"
咖啡	kā fēi	ka1 fei1	coffee; CL:杯[bei1]
开	kāi	kai1	to open; to start; to turn on; to boil; to write out (a medical prescription); to operate (vehicle); abbr. for 開爾文|开尔文 degrees Kelvin
开始	kāi shǐ	kai1 shi3	to begin; beginning; to start; initial; CL:個|个[ge4]
开玩笑	kāi wán xiào	kai1 wan2 xiao4	to play a joke; to make fun of; to joke
看	kàn	kan4	to see; to look at; to read; to watch; to consider; to regard as; to view as; to treat as; to judge; (after repeated verb) to give it a try; depending on (how you're judging); to visit; to call on; to treat (an illness); to look after; Watch out! (for a danger)
看法	kàn fǎ	kan4 fa3	way of looking at a thing; view; opinion; CL:個|个[ge4]
看见	kàn jiàn	kan4 jian4	to see; to catch sight of
考虑	kǎo lv4	kao3 lv4	to think over; to consider; consideration
考试	kǎo shì	kao3 shi4	exam; CL:次[ci4]
棵	kē	ke1	"classifier for trees, cabbages, plants etc"
科学	kē xué	ke1 xue2	"science; scientific knowledge; scientific; CL:門|门[men2],個|个[ge4],種|种[zhong3]"
咳嗽	ké sou	ke2 sou5	to cough; CL:陣|阵[zhen4]
渴	kě	ke3	thirsty
可爱	kě ài	ke3 ai4	amiable; cute; lovely
可怜	kě lián	ke3 lian2	pitiful; pathetic
可能	kě néng	ke3 neng2	might (happen); possible; probable; possibility; probability; maybe; perhaps; CL:個|个[ge4]
可是	kě shì	ke3 shi4	but; however
可惜	kě xī	ke3 xi1	it is a pity; what a pity; (it's) too bad
可以	kě yǐ	ke3 yi3	can; may; possible; able to
刻	kè	ke4	quarter (hour); moment; to carve; to engrave; to cut; oppressive; classifier for short time intervals
课	kè	ke4	"subject; course; class; lesson; CL:堂[tang2],节|節[jie2],門|门[men2]"
客人	kè rén	ke4 ren2	visitor; guest; customer; client; CL:位[wei4]
肯定	kěn dìng	ken3 ding4	to be sure; to be certain; sure; certain; definite; to confirm; to affirm; affirmative
空气	kōng qì	kong1 qi4	air; atmosphere
空调	kōng tiáo	kong1 tiao2	air conditioning
恐怕	kǒng pà	kong3 pa4	fear; to dread; I'm afraid that...; perhaps; maybe
口	kǒu	kou3	"mouth; classifier for things with mouths (people, domestic animals, cannons, wells etc)"
哭	kū	ku1	to cry; to weep
苦	kǔ	ku3	bitter; hardship; pain; to suffer; painstaking
裤子	kù zi	ku4 zi5	trousers; pants; CL:條|条[tiao2]
块	kuài	kuai4	"lump (of earth); chunk; piece; classifier for pieces of cloth, cake, soap etc; colloquial word for yuan (or other unit of currency such as Hong Kong or US dollar etc), usually as 塊錢|块钱"
快	kuài	kuai4	rapid; quick; speed; rate; soon; almost; to make haste; clever; sharp (of knives or wits); forthright; plain-spoken; gratified; pleased; pleasant
快乐	kuài lè	kuai4 le4	happy; merry
筷子	kuài zi	kuai4 zi5	"chopsticks; CL:對|对[dui4],根[gen1],把[ba3],雙|双[shuang1]"
宽	kuān	kuan1	lenient; wide; broad
困	kùn	kun4	to trap; to surround; hard-pressed; stranded; destitute
困难	kùn nan5	kun4 nan5	(financial etc) difficulty; problem; issue; CL:個|个[ge4]
扩大	kuò dà	kuo4 da4	to expand; to enlarge; to broaden one's scope
拉	lā	la1	to pull; to play (string instruments); to drag; to draw
垃圾桶	lā jī tǒng	la1 ji1 tong3	rubbish bin
辣	là	la4	hot (spicy); pungent
来	lái	lai2	to come; to arrive; to come round; ever since; next
来不及	lái bu jí	lai2 bu5 ji2	there's not enough time (to do sth); it's too late (to do sth)
来得及	lái de jí	lai2 de5 ji2	there's still time; able to do sth in time
蓝	lán	lan2	blue; indigo plant
懒	lǎn	lan3	lazy
浪费	làng fèi	lang4 fei4	to waste; to squander
浪漫	làng màn	lang4 man4	romantic
老	lǎo	lao3	prefix used before the surname of a person or a numeral indicating the order of birth of the children in a family or to indicate affection or familiarity; old (of people); venerable (person); experienced; of long standing; always; all the time; of the past; very; outdated; (of meat etc) tough
老虎	lǎo hǔ	lao3 hu3	tiger; CL:隻|只[zhi1]
老师	lǎo shī	lao3 shi1	"teacher; CL:個|个[ge4],位[wei4]"
了	le	le5	(modal particle intensifying preceding clause); (completed action marker)
累	lèi	lei4	tired; weary; to strain; to wear out; to work hard
冷	lěng	leng3	cold
冷静	lěng jìng	leng3 jing4	calm; cool-headed
离	lí	li2	to leave; to part from; to be away from; (in giving distances) from; without (sth); independent of; one of the eight trigrams of the Book of Changes representing fire (old)
离开	lí kāi	li2 kai1	to depart; to leave
里	lǐ	li3	lining; interior; inside; internal; also written 裡|里 [li3]
理发	lǐ fà	li3 fa4	a barber; hairdressing
理解	lǐ jiě	li3 jie3	to comprehend; to understand; comprehension; understanding
理想	lǐ xiǎng	li3 xiang3	a dream; an ideal; perfection; ideal; perfect; desirable; CL:個|个[ge4]
礼貌	lǐ mào	li3 mao4	courtesy; manners
礼物	lǐ wù	li3 wu4	"gift; present; CL:件[jian4],個|个[ge4],份[fen4]"
厉害	lì hai	li4 hai5	difficult to deal with; difficult to endure; ferocious; radical; serious; terrible; violent; tremendous; awesome
力气	lì qi	li4 qi5	strength; CL:把[ba3]
例如	lì rú	li4 ru2	for example; for instance; such as
历史	lì shǐ	li4 shi3	"history; CL:門|门[men2],段[duan4]"
俩	liǎ	lia3	two (colloquial equivalent of 兩個|两个); both; some
连	lián	lian2	"to link; to join; to connect; continuously; in succession; including; (used with 也, 都 etc) even; company (military)"
联系	lián xì	lian2 xi4	connection; contact; relation; in touch with; to integrate; to link; to touch
脸	liǎn	lian3	"face; CL:張|张[zhang1],個|个[ge4]"
练习	liàn xí	lian4 xi2	exercise; drill; practice; CL:個|个[ge4]
凉快	liáng kuai	liang2 kuai5	nice and cold; pleasantly cool
两	liǎng	liang3	both; two; ounce; some; a few; tael; weight equal to 50 grams
亮	liàng	liang4	bright; clear; resonant; to shine; to show; to reveal
辆	liàng	liang4	classifier for vehicles
聊天	liáo tiān	liao2 tian1	to chat; to gossip
了解	liǎo jiě	liao3 jie3	to understand; to realize; to find out
邻居	lín jū	lin2 ju1	neighbor; next door; CL:個|个[ge4]
零	líng	ling2	zero; nought; zero sign; fractional; fragmentary; odd (of numbers); (placed between two numbers to indicate a smaller quantity followed by a larger one); fraction; (in mathematics) remainder (after division); extra; to wither and fall; to wither
另外	lìng wài	ling4 wai4	additional; in addition; besides; separate; other; moreover; furthermore
留	liú	liu2	to leave (eg a message); to retain; to stay; to remain; to keep; to preserve
留学	liú xué	liu2 xue2	to study abroad
流泪	liú lèi	liu2 lei4	to shed tears
流利	liú lì	liu2 li4	fluent
流行	liú xíng	liu2 xing2	to spread; to rage (of contagious disease); popular; fashionable; prevalent; (math.) manifold
路	lù	lu4	road; path; way; CL:條|条[tiao2]
楼	lóu	lou2	"house with more than 1 story; storied building; floor; CL:層|层[ceng2],座[zuo4],棟|栋[dong4]"
乱	luàn	luan4	in confusion or disorder; in a confused state of mind; disorder; upheaval; riot; illicit sexual relations; to throw into disorder; to mix up; indiscriminate; random; arbitrary
旅游	lv3 yóu	lv3 you2	trip; journey; tourism; travel; tour
六	liù	liu4	six; 6
马	mǎ	ma3	horse; abbr. for Malaysia 馬來西亞|马来西亚
麻烦	má fan5	ma2 fan5	inconvenient; troublesome; to trouble or bother sb; to put sb to trouble
妈妈	mā ma	ma1 ma5	"mama; mommy; mother; CL:個|个[ge4],位[wei4]"
律师	lv4 shī	lv4 shi1	lawyer
绿	lv4	lv4	green
马虎	mǎ hu	ma3 hu5	careless; sloppy; negligent; skimpy
买	mǎi	mai3	to buy; to purchase
吗	ma	ma5	(question tag)
马上	mǎ shàng	ma3 shang4	"at once, right away, immediately; lit. on horseback"
卖	mài	mai4	to sell; to betray; to spare no effort; to show off or flaunt
满	mǎn	man3	full; filled; packed; fully; completely; quite; to reach the limit; to satisfy; satisfied; contented; to fill; abbr. for Manchurian
满意	mǎn yì	man3 yi4	satisfied; pleased; to one's satisfaction
慢	màn	man4	slow
忙	máng	mang2	busy; hurriedly
猫	māo	mao1	cat; CL:隻|只[zhi1]
毛巾	máo jīn	mao2 jin1	towel; CL:條|条[tiao2]
没	méi	mei2	(negative prefix for verbs); have not; not
帽子	mào zi	mao4 zi5	hat; cap; CL:頂|顶[ding3]
美丽	měi lì	mei3 li4	beautiful
每	měi	mei3	each; every
没关系	méi guān xi	mei2 guan1 xi5	it doesn't matter
米饭	mǐ fàn	mi3 fan4	(cooked) rice
门	mén	men2	"gate; door; CL:扇[shan4]; gateway; doorway; CL:個|个[ge4]; opening; valve; switch; way to do something; knack; family; house; (religious) sect; school (of thought); class; category; phylum or division (taxonomy); classifier for large guns; classifier for lessons, subjects, branches of technology"
妹妹	mèi mei	mei4 mei5	younger sister; fig. younger woman (esp. girl friend or rival); CL:個|个[ge4]
米	mǐ	mi3	rice; CL:粒[li4]; meter (classifier)
梦	mèng	meng4	"dream; CL:場|场[chang2],個|个[ge4]"
民族	mín zú	min2 zu2	nationality; ethnic group; CL:個|个[ge4]
密码	mì mǎ	mi4 ma3	code; secret code; password; pin number
免费	miǎn fèi	mian3 fei4	free (of charge)
面条	miàn tiáo	mian4 tiao2	noodles
面包	miàn bāo	mian4 bao1	"bread; CL:片[pian4],袋[dai4],塊|块[kuai4]"
明白	míng bai	ming2 bai5	clear; obvious; unequivocal; to understand; to realize
明天	míng tiān	ming2 tian1	tomorrow
名字	míng zi	ming2 zi5	name (of a person or thing); CL:個|个[ge4]
母亲	mǔ qīn	mu3 qin1	mother; also pr. with light tone [mu3 qin5]; CL:個|个[ge4]
目的	mù dì	mu4 di4	purpose; aim; goal; target; objective; CL:個|个[ge4]
拿	ná	na2	to hold; to seize; to catch; to apprehend; to take
哪	nǎ	na3	how; which
哪儿	nǎ r5	na3 r5	where?; wherever; anywhere
那	nà	na4	"that; those; then (in that case); commonly pr. nei4 before a classifier, esp. in Beijing"
那儿	nà r5	na4 r5	there
奶奶	nǎi nai	nai3 nai5	(informal) father's mother; paternal grandmother; CL:位[wei4]
耐心	nài xīn	nai4 xin1	patient (adjective)
南	nán	nan2	south
难	nán	nan2	difficult (to...); problem; difficulty; difficult; not good
难道	nán dào	nan2 dao4	don't tell me ...; could it be that...?
难过	nán guò	nan2 guo4	feel sorry; be grieved
难受	nán shòu	nan2 shou4	to feel unwell; to suffer pain; to be difficult to bear
男人	nán rén	nan2 ren2	a man; a male; men; CL:個|个[ge4]
呢	ne	ne5	(question particle for subjects already mentioned)
内	nèi	nei4	inside; inner; internal; within; interior
内容	nèi róng	nei4 rong2	"content; substance; details; CL:個|个[ge4],項|项[xiang4]"
能	néng	neng2	to be able to; to be capable of; ability; capability; able; capable; can possibly; (usually used in the negative) to have the possibility of
能力	néng lì	neng2 li4	capability; capable; able; ability; CL:個|个[ge4]
你	nǐ	ni3	"you (informal, as opposed to polite 您[nin2])"
年	nián	nian2	year; CL:個|个[ge4]
年级	nián jí	nian2 ji2	grade; CL:個|个[ge4]
年龄	nián líng	nian2 ling2	"(a person's) age; CL:把[ba3],個|个[ge4]"
年轻	nián qīng	nian2 qing1	young
鸟	niǎo	niao3	"bird; CL:隻|只[zhi1],群[qun2]"
您	nín	nin2	"you (polite, as opposed to informal 你[ni3])"
牛奶	niú nǎi	niu2 nai3	"cow's milk; CL:瓶[ping2],杯[bei1]"
农村	nóng cūn	nong2 cun1	rural area; village; CL:個|个[ge4]
弄	nòng	nong4	to do; to manage; to handle; to play with; to fool with; to mess with; to fix; to toy with
努力	nǔ lì	nu3 li4	great effort; to strive; to try hard
暖和	nuǎn huo	nuan3 huo5	warm; nice and warm
女儿	nv3 ér	nv3 er2	daughter
女人	nv3 rén	nv3 ren2	woman
偶尔	ǒu ěr	ou3 er3	occasionally; once in a while; sometimes
爬山	pá shān	pa2 shan1	to climb a mountain; to mountaineer; hiking; mountaineering
排列	pái liè	pai2 lie4	array; arrangement; permutation (i.e. ordered choice of n elements out of m)
盘子	pán zi	pan2 zi5	tray; plate; dish; CL:個|个[ge4]
判断	pàn duàn	pan4 duan4	to decide; to determine; CL:個|个[ge4]
旁边	páng biān	pang2 bian1	lateral; side; to the side; beside
胖	pàng	pang4	fat; plump
跑步	pǎo bù	pao3 bu4	to walk quickly; to march; to run
陪	péi	pei2	to accompany; to keep sb company
朋友	péng you	peng2 you5	"friend; CL:個|个[ge4],位[wei4]"
批评	pī píng	pi1 ping2	to criticize; criticism; CL:個|个[ge4]
皮肤	pí fū	pi2 fu1	skin; CL:種|种[zhong3]
啤酒	pí jiǔ	pi2 jiu3	"beer; CL:杯[bei1],瓶[ping2],罐[guan4],桶[tong3],缸[gang1]"
脾气	pí qì	pi2 qi4	temperament; disposition; temper; CL:個|个[ge4]
篇	piān	pian1	"sheet; piece of writing; bound set of bamboo slips used for record keeping (old); classifier for written items: chapter, article"
便宜	pián yi	pian2 yi5	small advantages; to let sb off lightly; cheap; inexpensive
骗	piàn	pian4	to cheat; to swindle; to deceive; to fool; to hoodwink; to trick
票	piào	piao4	ticket; ballot; bank note; CL:張|张[zhang1]; person held for ransom; amateur performance of Chinese opera; classifier for shipments and business transactions (topolect)
漂亮	piào liang5	piao4 liang5	pretty; beautiful
乒乓球	pīng pāng qiú	ping1 pang1 qiu2	table tennis; ping-pong; ping pong; table tennis ball; CL:個|个[ge4]
苹果	píng guǒ	ping2 guo3	"apple; CL:個|个[ge4],顆|颗[ke1]"
平时	píng shí	ping2 shi2	in normal times; in peacetime
瓶子	píng zi	ping2 zi5	bottle; CL:個|个[ge4]
破	pò	po4	"broken; damaged; worn out; to break, split or cleave; to get rid of; to destroy; to break with; to defeat; to capture (a city etc); to expose the truth of"
葡萄	pú tao	pu2 tao5	grape
普遍	pǔ biàn	pu3 bian4	universal; general; widespread; common
普通话	pǔ tōng huà	pu3 tong1 hua4	Mandarin (common language); Putonghua (common speech of the Chinese language); ordinary speech
七	qī	qi1	seven; 7
妻子	qī zi	qi1 zi5	wife; CL:個|个[ge4]
骑	qí	qi2	to ride (an animal or bike); to sit astride
其次	qí cì	qi2 ci4	next; secondly
其实	qí shí	qi2 shi2	"actually, in fact, really"
其他	qí tā	qi2 ta1	other; the others; else; other than (that person); in addition to the person mentioned above
其中	qí zhōng	qi2 zhong1	among; in; included among these
奇怪	qí guài	qi2 guai4	strange; odd
起床	qǐ chuáng	qi3 chuang2	to get up
起飞	qǐ fēi	qi3 fei1	to take off (in an airplane)
起来	qǐ lai	qi3 lai5	beginning or continuing an action; upward movement; stand up
气候	qì hòu	qi4 hou4	climate; atmosphere; situation; CL:種|种[zhong3]
千	qiān	qian1	thousand
千万	qiān wàn	qian1 wan4	ten million; countless; many; one must by all means
铅笔	qiān bǐ	qian1 bi3	"(lead) pencil; CL:支[zhi1],枝[zhi1],桿|杆[gan3]"
签证	qiān zhèng	qian1 zheng4	visa; certificate; to certify; CL:個|个[ge4]
钱	qián	qian2	coin; money; CL:筆|笔[bi3]
前面	qián miàn	qian2 mian4	ahead; in front; preceding; above
墙	qiáng	qiang2	"wall; CL:面[mian4],堵[du3]"
敲	qiāo	qiao1	extort; knock; to strike; to knock (at a door); to hit
桥	qiáo	qiao2	bridge; CL:座[zuo4]
巧克力	qiǎo kè lì	qiao3 ke4 li4	chocolate (loanword); CL:塊|块[kuai4]
亲戚	qīn qi	qin1 qi5	"a relative (i.e. family relation); CL:門|门[men2],個|个[ge4],位[wei4]"
轻	qīng	qing1	light; easy; gentle; soft; reckless; unimportant; frivolous; small in number; unstressed; neutral
轻松	qīng sōng	qing1 song1	gentle; relaxed
清楚	qīng chu	qing1 chu5	clear; clearly understood; distinct
晴	qíng	qing2	clear; fine (weather)
情况	qíng kuàng	qing2 kuang4	"circumstances; state of affairs; situation; CL:個|个[ge4],種|种[zhong3]"
请	qǐng	qing3	to ask; to invite; please (do sth); to treat (to a meal etc); to request
请假	qǐng jià	qing3 jia4	ask for time off
请客	qǐng kè	qing3 ke4	give a dinner party; entertain guests; invite to dinner
穷	qióng	qiong2	exhausted; poor
秋	qiū	qiu1	autumn; fall; harvest time; a swing; surname Qiu
区别	qū bié	qu1 bie2	difference; to distinguish; to discriminate; to make a distinction; CL:個|个[ge4]
取	qǔ	qu3	to take; to get; to choose; to fetch
去	qù	qu4	to go; to go to (a place); to cause to go or send (sb); to remove; to get rid of; (when used either before or after a verb) to go in order to do sth; to be apart from in space or time; (after a verb of motion indicates movement away from the speaker); (used after certain verbs to indicate detachment or separation); (of a time or an event etc) just passed or elapsed
去年	qù nián	qu4 nian2	last year
全部	quán bù	quan2 bu4	whole; entire; complete
缺点	quē diǎn	que1 dian3	weak point; fault; shortcoming; CL:個|个[ge4]
缺少	quē shǎo	que1 shao3	lack; shortage of; shortfall; to be short (of); to lack
却	què	que4	but; yet; however; while; to go back; to decline; to retreat; nevertheless; even though
确实	què shí	que4 shi2	indeed; really; reliable; real; true
群	qún	qun2	"group; crowd; flock, herd, pack etc"
裙子	qún zi	qun2 zi5	skirt; CL:條|条[tiao2]
然而	rán ér	ran2 er2	however; yet; but
然后	rán hòu	ran2 hou4	after; then (afterwards); after that; afterwards
让	ràng	rang4	to yield; to permit; to let sb do sth; to have sb do sth
热	rè	re4	heat; to heat up; fervent; hot (of weather); warm up
热闹	rè nao	re4 nao5	bustling with noise and excitement; lively
热情	rè qíng	re4 qing2	cordial; enthusiastic; passion; passionate; passionately
人	rén	ren2	"man; person; people; CL:個|个[ge4],位[wei4]"
人民币	rén mín bì	ren2 min2 bi4	Renminbi (RMB); Chinese Yuan (CNY)
任何	rèn hé	ren4 he2	any; whatever; whichever; whatsoever
任务	rèn wu	ren4 wu5	"mission; assignment; task; duty; role; CL:項|项[xiang4],個|个[ge4]"
认识	rèn shi	ren4 shi5	to know; to recognize; to be familiar with; acquainted with sth; knowledge; understanding; awareness; cognition
认为	rèn wéi	ren4 wei2	to believe; to think; to consider; to feel
认真	rèn zhēn	ren4 zhen1	conscientious; earnest; serious; to take seriously; to take to heart
扔	rēng	reng1	to throw; to throw away
仍然	réng rán	reng2 ran2	still; yet
日	rì	ri4	"sun; day; date, day of the month; abbr. for 日本|日本 Japan"
日记	rì jì	ri4 ji4	"diary; CL:則|则[ze2],本[ben3],篇[pian1]"
容易	róng yì	rong2 yi4	easy; likely; liable (to)
如果	rú guǒ	ru2 guo3	if; in case; in the event that
入口	rù kǒu	ru4 kou3	entrance
软	ruǎn	ruan3	soft; flexible
三	sān	san1	three; 3
伞	sǎn	san3	umbrella; parasol; CL:把[ba3]
散步	sàn bù	san4 bu4	to take a walk; to go for a walk
森林	sēn lín	sen1 lin2	forest; CL:片[pian4]
沙发	shā fā	sha1 fa1	"sofa; CL:條|条[tiao2],張|张[zhang1]"
商店	shāng diàn	shang1 dian4	"store; shop; CL:家[jia1],個|个[ge4]"
商量	shāng liang5	shang1 liang5	to consult; to talk over; to discuss
伤心	shāng xīn	shang1 xin1	to grieve; broken-hearted
上	shàng	shang4	on; on top; upon; first (of multiple parts); previous; last; upper; higher; above; to climb; to go into; to go up; to attend (class or university)
上班	shàng bān	shang4 ban1	to go to work; to be on duty; to start work; to go to the office
上网	shàng wǎng	shang4 wang3	to be on the internet; to stretch a net (in a sports game or for covering sth); to be netted (of fish)
上午	shàng wǔ	shang4 wu3	morning; CL:個|个[ge4]
稍微	shāo wēi	shao1 wei1	a little bit
少	shǎo	shao3	few; little; lack
社会	shè huì	she4 hui4	society; CL:個|个[ge4]
谁	shéi	shei2	who; also pronounced shui2
深	shēn	shen1	"close; deep; late; profound; dark (of color, water etc)"
申请	shēn qǐng	shen1 qing3	to apply for sth; application (form etc); CL:份[fen4]
身体	shēn tǐ	shen1 ti3	(human) body; health; CL:個|个[ge4]
什么	shén me	shen2 me5	what?; who?; something; anything
甚至	shèn zhì	shen4 zhi4	even; so much so that
生病	shēng bìng	sheng1 bing4	to fall ill; to sicken
生活	shēng huó	sheng1 huo2	life; activity; to live; livelihood
生命	shēng mìng	sheng1 ming4	life; living; biological; CL:個|个[ge4]
生气	shēng qì	sheng1 qi4	angry; mad; offended; animated; to get angry; to be enraged; to take offense; animation
生日	shēng rì	sheng1 ri4	birthday; CL:個|个[ge4]
声音	shēng yīn	sheng1 yin1	voice; sound; CL:個|个[ge4]
省	shěng	sheng3	to save; to economize; to do without; to omit; to leave out; province; CL:個|个[ge4]
剩	shèng	sheng4	to remain; to be left; to have as remainder
失败	shī bài	shi1 bai4	to be defeated; to lose; to fail (e.g. experiments); failure; defeat; CL:次[ci4]
失望	shī wàng	shi1 wang4	disappointed; to lose hope; to despair
师傅	shī fu	shi1 fu5	"master; qualified worker; respectful form of address for older men; CL:個|个[ge4],位[wei4],名[ming2]"
湿润	shī rùn	shi1 run4	moist
狮子	shī zi	shi1 zi5	"lion; CL:隻|只[zhi1],頭|头[tou2]; Leo (star sign)"
十	shí	shi2	ten; 10
十分	shí fēn	shi2 fen1	to divide into ten equal parts; very; hundred percent; completely; extremely; utterly; absolutely
时候	shí hou	shi2 hou5	time; length of time; moment; period
时间	shí jiān	shi2 jian1	time; period; CL:段[duan4]
实际	shí jì	shi2 ji4	actual; reality; practice
实在	shí zài	shi2 zai4	in reality; honestly; really; verily; concrete
食品	shí pǐn	shi2 pin3	foodstuff; food; provisions; CL:種|种[zhong3]
使	shǐ	shi3	to make; to cause; to enable; to use; to employ; to send; to instruct sb to do sth; envoy; messenger
使用	shǐ yòng	shi3 yong4	to use; to employ; to apply; to make use of
是	shì	shi4	is; are; am; yes; to be
试	shì	shi4	to test; to try; experiment; examination; test
市场	shì chǎng	shi4 chang3	market place; market (also in abstract); abbr. for 超級市場|超级市场 supermarket; CL:個|个[ge4]
适合	shì hé	shi4 he2	to fit; to suit
适应	shì yìng	shi4 ying4	to suit; to fit; to be suitable; to adapt; to get used to sth
世纪	shì jì	shi4 ji4	century; CL:個|个[ge4]
世界	shì jiè	shi4 jie4	world; CL:個|个[ge4]
事情	shì qíng	shi4 qing2	"affair; matter; thing; business; CL:件[jian4],樁|桩[zhuang1]"
收	shōu	shou1	to receive; to accept; to collect; in care of (used on address line after name)
收入	shōu rù	shou1 ru4	"to take in; income; revenue; CL:筆|笔[bi3],個|个[ge4]"
收拾	shōu shi	shou1 shi5	to put in order; to tidy up; to pack; to repair; to punish (colloquial); to manage
手表	shǒu biǎo	shou3 biao3	"wrist watch; CL:塊|块[kuai4],隻|只[zhi1],個|个[ge4]"
手机	shǒu jī	shou3 ji1	cell phone; cellular phone; mobile phone; CL:部[bu4]
首都	shǒu dū	shou3 du1	capital (city); CL:個|个[ge4]
首先	shǒu xiān	shou3 xian1	first (of all); in the first place
瘦	shòu	shou4	tight; thin; lean
受不了	shòu bù liǎo	shou4 bu4 liao3	unbearable; unable to endure; can't stand
受到	shòu dào	shou4 dao4	to receive; to suffer; obtained; given
售货员	shòu huò yuán	shou4 huo4 yuan2	salesperson; CL:個|个[ge4]
书	shū	shu1	"book; letter; CL:本[ben3],冊|册[ce4],部[bu4]; see also 書經|书经 Book of History"
输	shū	shu1	to lose; to transport; to donate; to enter (a password)
舒服	shū fu	shu1 fu5	comfortable; feeling well
叔叔	shū shu	shu1 shu5	father's younger brother; uncle; Taiwan pr. shu2 shu5; CL:個|个[ge4]
熟悉	shú xī	shu2 xi1	to be familiar with; to know well
树	shù	shu4	tree; CL:棵[ke1]
数量	shù liàng	shu4 liang4	amount; quantity; CL:個|个[ge4]
数学	shù xué	shu4 xue2	mathematics; mathematical
数字	shù zì	shu4 zi4	numeral; digit; number; figure; amount; digital (electronics etc); CL:個|个[ge4]
刷牙	shuā yá	shua1 ya2	to brush teeth
帅	shuài	shuai4	handsome; graceful; smart; commander in chief
双	shuāng	shuang1	two; double; pair; both
水	shuǐ	shui3	water; river; liquid; beverage; additional charges or income; (of clothes) classifier for number of washes
水果	shuǐ guǒ	shui3 guo3	fruit; CL:個|个[ge4]
水平	shuǐ píng	shui3 ping2	level (of achievement etc); standard; horizontal
睡觉	shuì jiào	shui4 jiao4	to go to bed; to go to sleep
顺便	shùn biàn	shun4 bian4	conveniently; in passing; without much extra effort
顺利	shùn lì	shun4 li4	smoothly; without a hitch
顺序	shùn xù	shun4 xu4	sequence; order
说话	shuō huà	shuo1 hua4	to speak; to say; to talk; to gossip; to tell stories; talk; word
说明	shuō míng	shuo1 ming2	to explain; to illustrate; explanation; directions; caption; CL:個|个[ge4]
硕士	shuò shì	shuo4 shi4	master's degree; learned person
司机	sī jī	si1 ji1	chauffeur; driver; CL:個|个[ge4]
死	sǐ	si3	to die; impassable; uncrossable; inflexible; rigid; extremely
四	sì	si4	four; 4
送	sòng	song4	to deliver; to carry; to give (as a present); to present (with); to see off; to send
速度	sù dù	su4 du4	speed; rate; velocity; CL:個|个[ge4]
塑料袋	sù liào dài	su4 liao4 dai4	plastic bag
酸	suān	suan1	sour; sore; ache; acid
算	suàn	suan4	regard as; to figure; to calculate; to compute
虽然	suī rán	sui1 ran2	although; even though; even if
随便	suí biàn	sui2 bian4	as one wishes; as one pleases; at random; negligent; casual; wanton
随着	suí zhe	sui2 zhe5	along with; in the wake of; following
岁	suì	sui4	classifier for years (of age); year; year (of crop harvests)
孙子	sūn zi	sun1 zi5	grandson; son's son
所以	suǒ yǐ	suo3 yi3	therefore; as a result; so
所有	suǒ yǒu	suo3 you3	all; to have; to possess; to own
他	tā	ta1	he or him; (used for either sex when the sex is unknown or unimportant); (used before sb's name for emphasis); (used as a meaningless mock object); other; another
她	tā	ta1	she
它	tā	ta1	it
台	tái	tai2	desk; platform; stage; terrace; stand; support; desk; station; broadcasting station; classifier for vehicles or machines; Taiwan (abbr.)
抬	tái	tai2	to lift; to raise; (of two or more persons) to carry
太	tài	tai4	highest; greatest; too (much); very; extremely
太阳	tài yáng	tai4 yang2	sun; CL:個|个[ge4]
态度	tài du	tai4 du5	manner; bearing; attitude; approach; CL:個|个[ge4]
谈	tán	tan2	to speak; to talk; to converse; to chat; to discuss
弹钢琴	tán gāng qín	tan2 gang1 qin2	play the piano
汤	tāng	tang1	soup; hot or boiling water; decoction of medicinal herbs; water in which sth has been boiled
趟	tāng	tang1	to wade; to trample; to turn the soil
糖	táng	tang2	"sugar; sweets; candy; CL:顆|颗[ke1],塊|块[kuai4]"
躺	tǎng	tang3	to recline; to lie down
讨论	tǎo lùn	tao3 lun4	to discuss; to talk over; CL:個|个[ge4]
讨厌	tǎo yàn	tao3 yan4	disgusting; troublesome; nuisance; nasty; to hate doing sth
特别	tè bié	te4 bie2	especially; special; particular; unusual
特点	tè diǎn	te4 dian3	characteristic (feature); trait; feature; CL:個|个[ge4]
疼	téng	teng2	(it) hurts; love fondly; ache; pain; sore
踢足球	tī zú qiú	ti1 zu2 qiu2	play soccer(football)
题	tí	ti2	"topic; problem for discussion; exam question; subject; to inscribe; to mention; surname Ti; CL:個|个[ge4],道[dao4]"
提高	tí gāo	ti2 gao1	to raise; to increase
提供	tí gōng	ti2 gong1	to offer; to supply; to provide; to furnish
提前	tí qián	ti2 qian2	to shift to an earlier date; to bring forward; to advance
提醒	tí xǐng	ti2 xing3	to remind; to call attention to; to warn of
体育	tǐ yù	ti3 yu4	sports; physical education
天气	tiān qì	tian1 qi4	weather
甜	tián	tian2	sweet
填空	tián kòng	tian2 kong4	to fill a job vacancy; to fill in a blank (e.g. on questionnaire or exam paper)
条	tiáo	tiao2	"strip; item; article; clause (of law or treaty); classifier for long thin things (ribbon, river, road, trousers etc)"
条件	tiáo jiàn	tiao2 jian4	condition; circumstances; term; factor; requirement; prerequisite; qualification; CL:個|个[ge4]
跳舞	tiào wǔ	tiao4 wu3	to dance
听	tīng	ting1	"to listen; to hear; to obey; a can (loanword from English ""tin""); classifier for canned beverages"
停止	tíng zhǐ	ting2 zhi3	to stop; to halt; to cease
挺	tǐng	ting3	to stick out; to (physically) straighten up; to endure or hold out; straight; stiff; outstanding; extraordinary; rather; quite; very; classifier for machine guns
通过	tōng guò	tong1 guo4	by means of; through; via; to pass through; to get through; to adopt; to pass (a bill); to switch over
通知	tōng zhī	tong1 zhi1	to notify; to inform; notice; notification; CL:個|个[ge4]
同情	tóng qíng	tong2 qing2	compassion; relent; sympathize; sympathy
同事	tóng shì	tong2 shi4	"colleague; co-worker; CL:個|个[ge4],位[wei4]"
同学	tóng xué	tong2 xue2	"(fellow) classmate; CL:位[wei4],個|个[ge4]"
同意	tóng yì	tong2 yi4	to agree; to consent; to approve
头发	tóu fa	tou2 fa5	hair (on the head)
突然	tū rán	tu1 ran2	sudden; abrupt; unexpected
图书馆	tú shū guǎn	tu2 shu1 guan3	"library; CL:家[jia1],個|个[ge4]"
推	tuī	tui1	to push; to cut; to refuse; to reject; to decline; to shirk (responsibility); to put off; to delay; to push forward; to nominate; to elect
推迟	tuī chí	tui1 chi2	to postpone; to put off; to defer
腿	tuǐ	tui3	leg; CL:條|条[tiao2]
脱	tuō	tuo1	to shed; to take off; to escape; to get away from
袜子	wà zi	wa4 zi5	"socks; stockings; CL:隻|只[zhi1],對|对[dui4],雙|双[shuang1]"
外	wài	wai4	outside; in addition; foreign; external
玩	wán	wan2	toy; sth used for amusement; curio or antique (Taiwan pr. wan4); to play; to have fun; to trifle with; to keep sth for entertainment
完	wán	wan2	to finish; to be over; whole; complete; entire
完成	wán chéng	wan2 cheng2	complete; accomplish; perfect tense (grammar)
完全	wán quán	wan2 quan2	complete; whole; totally; entirely
碗	wǎn	wan3	"bowl; cup; CL:隻|只[zhi1],個|个[ge4]"
晚上	wǎn shang5	wan3 shang5	in the evening; CL:個|个[ge4]
万	wàn	wan4	ten thousand; a great number
往	wǎng	wang3	to go (in a direction); to; towards; (of a train) bound for; past; previous
往往	wǎng wǎng	wang3 wang3	often; frequently
网球	wǎng qiú	wang3 qiu2	tennis; CL:個|个[ge4]
网站	wǎng zhàn	wang3 zhan4	website; network station; node
忘记	wàng jì	wang4 ji4	to forget
危险	wēi xiǎn	wei1 xian3	danger; dangerous
喂	wèi	wei4	"hello (interj., esp. on telephone); hey; to feed (sb or some animal)"
位	wèi	wei4	position; location; place; seat; classifier for people (honorific); classifier for binary bits (e.g. 十六位 16-bit or 2 bytes)
为	wèi	wei4	because of; for; to
为了	wèi le	wei4 le5	in order to; for the purpose of; so as to
为什么	wèi shén me	wei4 shen2 me5	why?; for what reason?
味道	wèi dào	wei4 dao4	flavor; smell; hint of
温度	wēn dù	wen1 du4	temperature; CL:個|个[ge4]
文化	wén huà	wen2 hua4	"culture; civilization; cultural; CL:個|个[ge4],種|种[zhong3]"
文章	wén zhāng	wen2 zhang1	"article; essay; literary works; writings; hidden meaning; CL:篇[pian1],段[duan4],頁|页[ye4]"
问	wèn	wen4	to ask
问题	wèn tí	wen4 ti2	question; problem; issue; topic; CL:個|个[ge4]
我	wǒ	wo3	I; me; my
我们	wǒ men5	wo3 men5	we; us; ourselves; our
握手	wò shǒu	wo4 shou3	to shake hands
污染	wū rǎn	wu1 ran3	pollution; contamination; CL:個|个[ge4]
无	wú	wu2	-less; not to have; no; none; not; to lack; un-
无聊	wú liáo	wu2 liao2	nonsense; bored
无论	wú lùn	wu2 lun4	no matter what or how; regardless of whether...
五	wǔ	wu3	five; 5
误会	wù huì	wu4 hui4	to misunderstand; to mistake; misunderstanding; CL:個|个[ge4]
西	xī	xi1	west
西瓜	xī guā	xi1 gua1	watermelon; CL:條|条[tiao2]
西红柿	xī hóng shì	xi1 hong2 shi4	tomato; CL:隻|只[zhi1]
希望	xī wàng	xi1 wang4	to wish for; to desire; hope CL:個|个[ge4]
吸引	xī yǐn	xi1 yin3	"to attract (interest, investment etc); CL:個|个[ge4]"
习惯	xí guàn	xi2 guan4	habit; custom; usual practice; to be used to; CL:個|个[ge4]
洗	xǐ	xi3	to wash; to bathe
洗手间	xǐ shǒu jiān	xi3 shou3 jian1	toilet; lavatory; washroom
洗衣机	xǐ yī jī	xi3 yi1 ji1	washer; washing machine; CL:臺|台[tai2]
洗澡	xǐ zǎo	xi3 zao3	to bathe; to take a shower
喜欢	xǐ huan5	xi3 huan5	to like; to be fond of
夏	xià	xia4	summer
下	xià	xia4	down; downwards; below; lower; later; next (week etc); second (of two parts); to decline; to go down
下午	xià wǔ	xia4 wu3	afternoon; p.m.; CL:個|个[ge4]
下雨	xià yǔ	xia4 yu3	to rain; rainy
先	xiān	xian1	early; prior; former; in advance; first
先生	xiān sheng5	xian1 sheng5	"teacher; Mister (Mr.); husband; doctor (topolect); CL:個|个[ge4],位[wei4]"
咸	xián	xian2	salted; salty; stingy; miserly
现代	xiàn dài	xian4 dai4	modern times; modern age; modern era
现在	xiàn zài	xian4 zai4	now; at present; at the moment; modern; current; nowadays
羡慕	xiàn mù	xian4 mu4	envious; envy; to admire
限制	xiàn zhì	xian4 zhi4	to restrict; to limit; to confine; restriction; limit; CL:個|个[ge4]
香	xiāng	xiang1	fragrant; sweet smelling; aromatic; savory or appetizing; (to eat) with relish; (of sleep) sound; perfume or spice; joss or incense stick; CL:根[gen1]
香蕉	xiāng jiāo	xiang1 jiao1	"banana; CL:枝[zhi1],根[gen1],個|个[ge4],把[ba3]"
相反	xiāng fǎn	xiang1 fan3	opposite; contrary
相同	xiāng tóng	xiang1 tong2	identical; same
相信	xiāng xìn	xiang1 xin4	be convinced (that something is true); believe; to accept sth as true
详细	xiáng xì	xiang2 xi4	detailed; in detail; minute
响	xiǎng	xiang3	to make a sound; to sound; to ring; loud; classifier for noises
想	xiǎng	xiang3	to think; to believe; to suppose; to wish; to want; to miss
向	xiàng	xiang4	direction; orientation; to face; to turn toward; to; towards; shortly before; formerly; to side with; to be partial to; all along (previously); surname Xiang
像	xiàng	xiang4	(look) like; similar (to); appearance; to appear; to seem; image; portrait; resemble; seem
消息	xiāo xi	xiao1 xi5	news; information; CL:條|条[tiao2]
小	xiǎo	xiao3	small; tiny; few; young
小姐	xiǎo jie	xiao3 jie5	"young lady; miss; CL:個|个[ge4],位[wei4]"
小时	xiǎo shí	xiao3 shi2	hour; CL:個|个[ge4]
小说	xiǎo shuō	xiao3 shuo1	"novel; fiction; CL:本[ben3],部[bu4]"
小心	xiǎo xīn	xiao3 xin1	to be careful; to take care
笑	xiào	xiao4	laugh; smile; CL:個|个[ge4]
笑话	xiào huà	xiao4 hua4	joke; jest; CL:個|个[ge4]
效果	xiào guǒ	xiao4 guo3	result; effect; quality; CL:個|个[ge4]
校长	xiào zhǎng	xiao4 zhang3	"(college, university) president; headmaster; CL:個|个[ge4],位[wei4],名[ming2]"
些	xiē	xie1	some; few; several; (a measure word)
鞋	xié	xie2	"shoe; CL:雙|双[shuang1],隻|只[zhi1]"
写	xiě	xie3	to write
谢谢	xiè xie	xie4 xie5	to thank; thanks
新	xīn	xin1	new; newly; meso- (chemistry)
新闻	xīn wén	xin1 wen2	"news; CL:條|条[tiao2],個|个[ge4]"
新鲜	xīn xiān	xin1 xian1	"fresh (experience, food etc); freshness"
辛苦	xīn kǔ	xin1 ku3	hard; exhausting; with much toil; thanks for your trouble
心情	xīn qíng	xin1 qing2	mood; frame of mind; CL:個|个[ge4]
信	xìn	xin4	letter; mail; to trust; to believe; to profess faith in; truthful; confidence; trust; at will; at random
信任	xìn rèn	xin4 ren4	to trust; to have confidence in
信心	xìn xīn	xin4 xin1	confidence; faith (in sb or sth); CL:個|个[ge4]
信用卡	xìn yòng kǎ	xin4 yong4 ka3	credit card
兴奋	xīng fèn	xing1 fen4	excited; excitement
星期	xīng qī	xing1 qi1	week; CL:個|个[ge4]
行	xíng	xing2	to walk; to go; to travel; a visit; temporary; makeshift; current; in circulation; to do; to perform; capable; competent; effective; all right; OK!; will do
行李箱	xíng li xiāng	xing2 li5 xiang1	suitcase
醒	xǐng	xing3	to wake up; to awaken; to be awake
姓	xìng	xing4	family name; surname; name; CL:個|个[ge4]
性别	xìng bié	xing4 bie2	gender; sex; distinguishing between the sexes
性格	xìng gé	xing4 ge2	nature; disposition; temperament; character; CL:個|个[ge4]
幸福	xìng fú	xing4 fu2	blessed; happiness; happy
兴趣	xìng qu	xing4 qu5	interest in (something); CL:個|个[ge4]
熊猫	xióng māo	xiong2 mao1	panda; CL:隻|只[zhi1]
修	xiū	xiu1	to decorate; to embellish; to repair; to build; to study; to write; to cultivate
休息	xiū xi	xiu1 xi5	rest; to rest
需要	xū yào	xu1 yao4	to need; to want; to demand; needs; to require
许多	xǔ duō	xu3 duo1	many; a lot of; much
选择	xuǎn zé	xuan3 ze2	to select; to pick; choice; option; alternative
学生	xué sheng5	xue2 sheng5	student; school child
学习	xué xí	xue2 xi2	to learn; to study
学校	xué xiào	xue2 xiao4	school; CL:所[suo3]
雪	xuě	xue3	"snow; snowfall; CL:場|场[chang2]; to have the appearance of snow; to wipe away, off or out; to clean"
血	xuè	xue4	"blood; informal colloquial and Taiwan pr. xie3; also pr. xue3; CL:滴[di1],片[pian4]"
压力	yā lì	ya1 li4	pressure
牙膏	yá gāo	ya2 gao1	toothpaste; CL:管[guan3]
亚洲	yà zhōu	Ya4 zhou1	Asia; Asian
呀	ya	ya5	"(particle equivalent to 啊 after a vowel, expressing surprise or doubt)"
盐	yán	yan2	salt; CL:粒[li4]
严格	yán gé	yan2 ge2	strict; stringent; tight; rigorous
严重	yán zhòng	yan2 zhong4	grave; serious; severe; critical
研究生	yán jiū shēng	yan2 jiu1 sheng1	graduate student; postgraduate student; research student
颜色	yán sè	yan2 se4	color; CL:個|个[ge4]
演出	yǎn chū	yan3 chu1	"to act (in a play); to perform; to put on (a performance); performance; concert; show; CL:場|场[chang2],次[ci4]"
演员	yǎn yuán	yan3 yuan2	"actor or actress; performer; CL:個|个[ge4],位[wei4],名[ming2]"
眼镜	yǎn jìng	yan3 jing4	spectacles; eyeglasses; CL:副[fu4]
眼睛	yǎn jing5	yan3 jing5	"eye; CL:隻|只[zhi1],雙|双[shuang1]"
阳光	yáng guāng	yang2 guang1	sunshine; CL:線|线[xian4]
羊肉	yáng ròu	yang2 rou4	mutton
养成	yǎng chéng	yang3 cheng2	to cultivate; to raise; to form (a habit); to acquire
样子	yàng zi	yang4 zi5	manner; air; looks; aspect
邀请	yāo qǐng	yao1 qing3	to invite; invitation; CL:個|个[ge4]
要求	yāo qiú	yao1 qiu2	to request; to require; to stake a claim; to ask; to demand; CL:點|点[dian3]
要	yào	yao4	important; vital; to want; will; going to (as future auxiliary); may; must
药	yào	yao4	"medicine; drug; cure; CL:種|种[zhong3],服[fu4]"
钥匙	yào shi	yao4 shi5	key; CL:把[ba3]
爷爷	yé ye	ye2 ye5	(informal) father's father; paternal grandfather; CL:個|个[ge4]
也	yě	ye3	also; too; (in classical Chinese) final particle serving as copula
也许	yě xǔ	ye3 xu3	perhaps; maybe
页	yè	ye4	page; leaf
叶子	yè zi	ye4 zi5	foliage; leaf; CL:片[pian4]
一	yī	yi1	"one; 1; single; a (article); as soon as; entire; whole; all; throughout; ""one"" radical in Chinese characters (Kangxi radical 1)"
衣服	yī fu	yi1 fu5	"clothes; CL:件[jian4],套[tao4]"
医生	yī shēng	yi1 sheng1	"doctor; CL:個|个[ge4],位[wei4],名[ming2]"
医院	yī yuàn	yi1 yuan4	"hospital; CL:所[suo3],家[jia1],座[zuo4]"
一定	yí dìng	yi2 ding4	surely; certainly; necessarily; fixed; a certain (extent etc); given; particular; must
一共	yí gòng	yi2 gong4	altogether
一会儿	yí huì r5	yi2 hui4 r5	a while
一切	yí qiè	yi2 qie4	everything; every; all
一样	yí yàng	yi2 yang4	same; like; equal to; the same as; just like
以	yǐ	yi3	to use; according to; so as to; by means of; in order to; by; with; because
以后	yǐ hòu	yi3 hou4	after; later; afterwards; following; later on; in the future
以前	yǐ qián	yi3 qian2	before; formerly; previous; ago
以为	yǐ wéi	yi3 wei2	to believe; to think; to consider; to be under the impression
已经	yǐ jīng	yi3 jing1	already
椅子	yǐ zi	yi3 zi5	"chair; CL:把[ba3],套[tao4]"
亿	yì	yi4	a hundred million; calculate
一般	yì bān	yi4 ban1	same; ordinary; common; general; generally; in general
一边	yì biān	yi4 bian1	one side; either side; on the one hand; on the other hand; doing while
一起	yì qǐ	yi4 qi3	in the same place; together; with; altogether (in total)
一直	yì zhí	yi4 zhi2	straight (in a straight line); continuously; always; from the beginning of ... up to ...; all along
意见	yì jiàn	yi4 jian4	"idea; opinion; suggestion; objection; complaint; CL:點|点[dian3],條|条[tiao2]"
意思	yì si	yi4 si5	idea; opinion; meaning; wish; desire; CL:個|个[ge4]
艺术	yì shù	yi4 shu4	art; CL:種|种[zhong3]
阴	yīn	yin1	overcast (weather); cloudy; shady; Yin (the negative principle of Yin and Yang); negative (electric.); feminine; moon; implicit; hidden; genitalia
因此	yīn cǐ	yin1 ci3	thus; consequently; as a result
因为	yīn wèi	yin1 wei4	because; owing to; on account of
音乐	yīn yuè	yin1 yue4	"music; CL:張|张[zhang1],曲[qu3],段[duan4]"
银行	yín háng	yin2 hang2	"bank; CL:家[jia1],個|个[ge4]"
饮料	yǐn liào	yin3 liao4	drink; beverage
引起	yǐn qǐ	yin3 qi3	to give rise to; to lead to; to cause; to arouse
印象	yìn xiàng	yin4 xiang4	impression; reflection; perception; CL:個|个[ge4]
应该	yīng gāi	ying1 gai1	ought to; should; must
赢	yíng	ying2	to beat; to win; to profit
影响	yǐng xiǎng	ying3 xiang3	an influence; an effect; to influence; to affect (usually adversely); to disturb; CL:股[gu3]
硬	yìng	ying4	hard; stiff; strong; firm; to manage to do sth with difficulty; good (quality); able (person)
勇敢	yǒng gǎn	yong3 gan3	brave; courageous
永远	yǒng yuǎn	yong3 yuan3	forever; eternal
用	yòng	yong4	to use; to employ; to have to; to eat or drink; expense or outlay; usefulness; hence; therefore
优点	yōu diǎn	you1 dian3	merit; benefit; strong point; advantage; CL:個|个[ge4]
优秀	yōu xiù	you1 xiu4	outstanding; excellent
幽默	yōu mò	you1 mo4	humor; humorous
由	yóu	you2	to follow; from; it is for...to; reason; cause; because of; due to; to; to leave it (to sb); by (introduces passive verb)
由于	yóu yú	you2 yu2	due to; as a result of; thanks to; owing to; since; because
尤其	yóu qí	you2 qi2	especially; particularly
游戏	yóu xì	you2 xi4	game; play; CL:場|场[chang3]
游泳	yóu yǒng	you2 yong3	swim
有	yǒu	you3	to have; there is; there are; to exist; to be
有名	yǒu míng	you3 ming2	famous; well-known
有趣	yǒu qù	you3 qu4	interesting; fascinating; amusing
友好	yǒu hǎo	you3 hao3	friendly (relations)
友谊	yǒu yì	you3 yi4	companionship; fellowship; friendship
又	yòu	you4	(once) again; also; both... and...; again
右边	yòu bian5	you4 bian5	"right side; right, to the right"
鱼	yú	yu2	"fish; CL:條|条[tiao2],尾[wei3]"
愉快	yú kuài	yu2 kuai4	cheerful; cheerily; delightful; pleasant; pleasantly; pleasing; happy; delighted
于是	yú shì	yu2 shi4	thereupon; as a result; consequently; thus; hence
与	yú	yu2	"(same as 歟|欤, final particle expression doubt or surprise, similar to 吗 or 呢)"
语法	yǔ fǎ	yu3 fa3	grammar
语言	yǔ yán	yu3 yan2	"language; CL:門|门[men2],種|种[zhong3]"
羽毛球	yǔ máo qiú	yu3 mao2 qiu2	shuttlecock; badminton; CL:個|个[ge4]
遇到	yù dào	yu4 dao4	to meet; to run into; to come across
预习	yù xí	yu4 xi2	to prepare a lesson
元	yuán	yuan2	Chinese monetary unit; dollar; primary; first; the Yuan or Mongol dynasty (1279-1368); surname Yuan
圆	yuán	yuan2	circle; round; circular; spherical; (of the moon) full; unit of Chinese currency (Yuan); tactful; to justify
原来	yuán lái	yuan2 lai2	original; former; originally; formerly; at first; so... actually
原谅	yuán liàng	yuan2 liang4	to excuse; to forgive; to pardon
原因	yuán yīn	yuan2 yin1	cause; origin; root cause; reason; CL:個|个[ge4]
远	yuǎn	yuan3	far; distant; remote
愿意	yuàn yì	yuan4 yi4	to wish; to want; ready; willing (to do sth)
约会	yuē huì	yue1 hui4	"appointment; engagement; date; CL:次[ci4],個|个[ge4]"
越	yuè	yue4	to exceed; to climb over; to surpass; the more... the more
月	yuè	yue4	"moon; month; CL:個|个[ge4],輪|轮[lun2]"
月亮	yuè liang5	yue4 liang5	moon
阅读	yuè dú	yue4 du2	to read; reading
云	yún	yun2	(classical) to say
允许	yǔn xǔ	yun3 xu3	to permit; to allow
运动	yùn dòng	yun4 dong4	movement; campaign; CL: 場|场[chang3]; sports
杂志	zá zhì	za2 zhi4	"magazine; CL:本[ben3],份[fen4],期[qi1]"
在	zài	zai4	(located) at; (to be) in; to exist; in the middle of doing sth; (indicating an action in progress)
再	zài	zai4	"again; once more; re-; second; another; then (after sth, and not until then)"
再见	zài jiàn	zai4 jian4	goodbye; see you again later
咱们	zán men5	zan2 men5	we or us (including both the speaker and the person(s) spoken to); I or me; you
暂时	zàn shí	zan4 shi2	temporary; provisional; for the time being
脏	zàng	zang4	viscera; (anatomy) organ
早上	zǎo shang5	zao3 shang5	early morning; CL:個|个[ge4]; Good morning!
责任	zé rèn	ze2 ren4	responsibility; blame; duty; CL:個|个[ge4]
怎么	zěn me	zen3 me5	how?; what?; why?
怎么样	zěn me yàng	zen3 me5 yang4	how?; how about?; how was it?; how are things?
增加	zēng jiā	zeng1 jia1	to raise; to increase
增长	zēng zhǎng	zeng1 zhang3	to grow; to increase
窄	zhǎi	zhai3	narrow; narrow-minded; badly off
站	zhàn	zhan4	station; to stand; to halt; to stop; branch of a company or organisation
张	zhāng	zhang1	"to open up; to spread; sheet of paper; classifier for flat objects, sheet; classifier for votes"
丈夫	zhàng fu	zhang4 fu5	husband; CL:個|个[ge4]
招聘	zhāo pìn	zhao1 pin4	recruitment; to invite applications for a job
着急	zháo jí	zhao2 ji2	to worry; to feel anxious
找	zhǎo	zhao3	to try to find; to look for; to call on sb; to find; to seek; to return; to give change
照顾	zhào gu	zhao4 gu5	to take care of; to show consideration; to attend to; to look after
照片	zhào piàn	zhao4 pian4	"photo; photograph; picture; CL:張|张[zhang1],套[tao4],幅[fu2]"
照相机	zhào xiàng jī	zhao4 xiang4 ji1	"camera; CL:個|个[ge4],架[jia4],部[bu4],台[tai2],隻|只[zhi1]"
这	zhè	zhe4	"this; these; (commonly pr. zhei4 before a classifier, esp. in Beijing)"
这儿	zhè r5	zhe4 r5	here
着	zhe	zhe5	"particle attached after verb to indicate action in progress, like -ing ending"
真	zhēn	zhen1	really; truly; indeed; real; true; genuine
真正	zhēn zhèng	zhen1 zheng4	genuine; real; true; genuinely
整理	zhěng lǐ	zheng3 li3	"to arrange; to tidy up; to sort out; to straighten out; to list systematically; to collate (data, files); to pack (luggage)"
整齐	zhěng qí	zheng3 qi2	orderly; neat; even; tidy
正常	zhèng cháng	zheng4 chang2	regular; normal; ordinary
正好	zhèng hǎo	zheng4 hao3	just (in time); just right; just enough; to happen to; to chance to; by chance; it just so happens that
正确	zhèng què	zheng4 que4	correct; proper
正式	zhèng shì	zheng4 shi4	formal; official
正在	zhèng zài	zheng4 zai4	in the process of (doing something or happening); while (doing)
证明	zhèng míng	zheng4 ming2	proof; certificate; identification; testimonial; CL:個|个[ge4]; to prove; to testify; to confirm the truth of
之	zhī	zhi1	"(possessive particle, literary equivalent of 的); him; her; it"
只	zhǐ	zhi1	"classifier for birds and certain animals, one of a pair, some utensils, vessels etc"
支持	zhī chí	zhi1 chi2	to be in favor of; to support; to back; support; backing; to stand by; CL:個|个[ge4]
知道	zhī dao	zhi1 dao5	to know; to be aware of
知识	zhī shi	zhi1 shi5	intellectual; knowledge-related; knowledge; CL:門|门[men2]
值得	zhí de	zhi2 de5	to be worth; to deserve
直接	zhí jiē	zhi2 jie1	direct; opposite: indirect 間接|间接; immediate; directly; straightforward
植物	zhí wù	zhi2 wu4	botanical; plant; vegetation; CL:種|种[zhong3]
职业	zhí yè	zhi2 ye4	occupation; profession; vocation; professional
指	zhǐ	zhi3	finger; to point at or to; to indicate or refer to; to depend on; to count on; (of hair) to stand on end
只好	zhǐ hǎo	zhi3 hao3	without any better option; to have to; to be forced to
只要	zhǐ yào	zhi3 yao4	if only; so long as
质量	zhì liàng	zhi4 liang4	quality; mass (in physics); CL:個|个[ge4]
至少	zhì shǎo	zhi4 shao3	at least; (to say the) least
制造	zhì zào	zhi4 zao4	to manufacture; to make
中国	zhōng guó	Zhong1 guo2	China; Middle Kingdom
中间	zhōng jiān	zhong1 jian1	between; intermediate; mid; middle
中文	zhōng wén	Zhong1 wen2	Chinese; Chinese written language; Chinese writing
中午	zhōng wǔ	zhong1 wu3	noon; midday; CL:個|个[ge4]
终于	zhōng yú	zhong1 yu2	at last; in the end; finally; eventually
种	zhǒng	zhong3	"abbr. for 物種|物种, genus; race; seed; breed; species; strain; kind; type; has guts (i.e. courage); nerve; classifier for types: kind, sort; classifier for languages"
重点	zhòng diǎn	zhong4 dian3	emphasis; focal point; priority; key; with the emphasis on; focusing on
重视	zhòng shì	zhong4 shi4	to attach importance to sth; to value
重要	zhòng yào	zhong4 yao4	important; significant; major
周末	zhōu mò	zhou1 mo4	weekend
周围	zhōu wéi	zhou1 wei2	surroundings; environment; to encompass
猪	zhū	zhu1	"hog; pig; swine; CL:口[kou3],頭|头[tou2]"
逐渐	zhú jiàn	zhu2 jian4	gradually
主动	zhǔ dòng	zhu3 dong4	to take the initiative; to do sth of one's own accord; active; opposite: passive 被動|被动[bei4 dong4]; drive (of gears and shafts etc)
主要	zhǔ yào	zhu3 yao4	main; principal; major; primary
主意	zhǔ yi	zhu3 yi5	plan; idea; decision; CL:個|个[ge4]
住	zhù	zhu4	to live; to dwell; to stay; to reside; to stop
祝	zhù	zhu4	invoke; pray to; wish; to express good wishes; surname Zhu
祝贺	zhù hè	zhu4 he4	to congratulate; congratulations; CL:個|个[ge4]
著名	zhù míng	zhu4 ming2	famous; noted; well-known; celebrated
注意	zhù yì	zhu4 yi4	to take note of; to pay attention to
专门	zhuān mén	zhuan1 men2	specialist; specialized; customized
专业	zhuān yè	zhuan1 ye4	"specialty; specialized field; main field of study (at university); major; CL:門|门[men2],個|个[ge4]; professional"
赚	zhuàn	zhuan4	earn; make a profit
撞	zhuàng	zhuang4	to hit; to strike; to meet by accident; to run into; to bump against; to bump into
准备	zhǔn bèi	zhun3 bei4	preparation; prepare
准确	zhǔn què	zhun3 que4	accurate; exact; precise
准时	zhǔn shí	zhun3 shi2	on time; punctual; on schedule
桌子	zhuō zi	zhuo1 zi5	"table; desk; CL:張|张[zhang1],套[tao4]"
仔细	zǐ xì	zi3 xi4	careful; attentive; cautious
字	zì	zi4	letter; symbol; character; word; CL:個|个[ge4]; courtesy or style name traditionally given to males aged 20 in dynastic China
字典	zì diǎn	zi4 dian3	dictionary; character dictionary; CL:本[ben3]
自己	zì jǐ	zi4 ji3	self; (reflexive pronoun); own
自然	zì rán	zi4 ran2	nature; natural; naturally
自行车	zì xíng chē	zi4 xing2 che1	bicycle; bike; CL:輛|辆[liang4]
总结	zǒng jié	zong3 jie2	to sum up; to conclude; summary; resume; CL:個|个[ge4]
总是	zǒng shì	zong3 shi4	always
走	zǒu	zou3	"to walk; to go; to run; to move (of vehicle); to visit; to leave; to go away; to die (euph.); from; through; away (in compound verbs, such as 撤走); to change (shape, form, meaning)"
租	zū	zu1	to hire; to rent; to charter; to rent out; to lease out; rent; land tax
组成	zǔ chéng	zu3 cheng2	component; part; element; constitute; make up
组织	zǔ zhī	zu3 zhi1	to organize; organization; organized system; nerve; tissue; CL:個|个[ge4]
嘴	zuǐ	zui3	"mouth; beak; spout (of teapot etc); CL:張|张[zhang1],個|个[ge4]"
最	zuì	zui4	most; the most; -est
最好	zuì hǎo	zui4 hao3	best; (you) had better (do what we suggest)
最后	zuì hòu	zui4 hou4	final; last; finally; ultimate
最近	zuì jìn	zui4 jin4	recent; recently; these days; latest; soon; nearest (of locations); shortest (of routes)
尊重	zūn zhòng	zun1 zhong4	esteem; respect; to honor; to value sth
昨天	zuó tiān	zuo2 tian1	yesterday
左边	zuǒ bian5	zuo3 bian5	left; the left side; to the left of
坐	zuò	zuo4	"to sit; to take a seat; to take (a bus, airplane etc); to bear fruit; surname Zuo"
做	zuò	zuo4	to do; to make; to produce; to write; to compose; to act as; to engage in; to hold (a party); to be; to become; to function (in some capacity); to serve as; to be used for; to form (a bond or relationship); to pretend; to feign; to act a part; to put on appearance
做生意	zuò shēng yì	zuo4 sheng1 yi4	to do business
座	zuò	zuo4	"seat; base; stand; CL:個|个[ge4]; classifier for buildings, mountains and similar immovable objects"
座位	zuò wèi	zuo4 wei4	seat; CL:個|个[ge4]
作业	zuò yè	zuo4 ye4	school assignment; homework; work; task; operation; to operate; CL:個|个[ge4]
作用	zuò yòng	zuo4 yong4	"to act on; to affect; action; function; activity; impact; result; effect; purpose; intent; to play a role; corresponds to English -ity, -ism, -ization; CL:個|个[ge4]"
作者	zuò zhě	zuo4 zhe3	author; writer; CL:個|个[ge4]